280,405,280,407,280,280,280,280,280,406,280,280,280,280,280,280,280,280,280,280,280,280,280,280,280,280,280,280,280,280,280,280,280,280,280,280,280,280,280,280,280,280,280,280,280,280,280,280,280,280,280,280,280,280,280,280,280,280,280,280,280,280,280,280,280,280,280,280,280,280,280,280,280,280,406,280,280,280,280,280
280,406,280,362,280,280,280,280,280,280,280,280,280,280,280,280,280,280,280,280,280,280,280,280,280,280,280,280,280,280,280,280,280,280,280,280,280,280,361,280,407,280,280,280,280,406,280,280,280,280,280,280,280,280,280,280,280,280,280,280,280,280,280,280,405,280,280,280,406,280,280,280,280,280,280,280,280,280,280,280
280,406,362,361,280,280,280,280,280,280,280,280,280,280,280,280,280,280,280,280,280,407,280,280,280,280,280,361,280,280,280,280,280,280,280,280,280,280,280,280,280,280,280,280,280,280,280,280,280,280,280,280,280,280,280,280,280,280,280,280,280,280,280,280,280,280,280,360,280,280,280,280,280,280,280,280,280,280,280,280
280,280,280,407,361,360,407,362,361,360,280,280,280,280,280,280,280,280,360,280,407,405,280,361,407,361,406,405,280,280,280,406,407,406,360,362,362,280,280,280,280,360,280,280,280,280,280,280,280,280,280,280,280,280,280,280,280,280,280,280,280,280,280,280,280,280,280,280,280,280,361,280,280,280,280,280,280,406,280,280
280,280,280,280,280,280,280,280,280,280,280,280,280,280,280,280,361,362,280,361,280,280,280,280,280,280,280,280,280,280,280,280,280,280,280,280,362,280,280,280,280,280,280,280,225,226,226,226,227,280,280,280,280,280,280,280,280,280,280,280,280,280,280,280,280,280,280,280,280,280,362,405,280,280,280,280,280,406,280,280
280,280,280,280,280,280,280,280,280,280,280,280,280,280,280,280,280,405,280,280,280,280,280,280,280,280,280,280,280,280,280,225,226,226,226,227,280,280,280,225,226,227,280,225,286,271,271,271,272,280,280,280,280,280,280,280,280,280,280,280,280,280,280,280,280,280,280,280,280,280,280,362,280,280,280,280,280,406,280,280
280,280,280,280,280,406,280,280,280,280,280,280,280,280,280,360,280,280,280,280,280,280,280,280,280,280,280,280,225,226,227,270,271,271,271,285,227,280,225,286,271,285,226,240,271,271,271,271,285,226,280,280,280,280,280,280,280,280,280,280,280,280,280,407,280,280,280,361,280,280,280,280,280,280,280,280,280,362,280,280
280,280,280,361,280,280,280,280,280,280,360,280,280,405,406,360,280,280,280,280,280,280,280,280,280,280,225,226,286,271,285,286,271,271,271,271,285,227,270,271,271,271,271,271,228,229,230,271,271,271,280,280,280,280,280,280,280,280,280,280,280,280,280,360,280,280,280,362,361,280,280,280,280,280,280,280,280,280,280,280
280,280,280,405,280,280,405,280,280,361,406,280,280,280,280,280,406,280,280,280,407,280,280,225,226,226,286,271,271,271,271,240,241,271,271,363,271,285,286,271,271,228,229,230,273,274,287,229,229,280,280,280,280,280,280,280,280,280,280,280,280,280,280,280,280,280,280,280,280,280,280,280,280,280,280,280,280,280,280,280
280,280,280,280,280,280,360,280,280,280,280,280,280,405,280,280,280,280,280,280,280,280,225,286,271,271,408,271,271,409,271,285,286,271,271,271,271,271,409,271,271,273,274,275,273,274,274,274,280,280,280,280,280,280,280,280,280,280,280,280,280,280,280,280,280,280,280,280,280,280,280,280,280,280,280,280,280,280,280,280
280,280,406,362,280,280,280,280,280,280,280,280,280,280,280,280,280,225,226,226,226,226,286,271,271,271,271,271,271,271,271,271,241,271,408,271,271,271,271,271,271,318,243,287,288,274,280,280,280,280,280,280,280,280,280,280,280,280,280,280,280,280,280,280,280,280,280,280,280,362,280,280,280,280,280,280,280,280,280,280
280,362,362,361,280,405,361,280,405,280,280,225,226,226,226,226,226,286,271,271,271,271,271,271,271,408,271,271,271,228,229,230,271,271,271,271,364,271,408,271,228,229,288,274,274,274,280,225,226,227,280,280,280,280,280,280,280,280,280,280,280,280,280,280,280,280,280,280,280,280,280,280,280,280,280,280,280,280,280,280
280,405,361,280,280,280,280,280,280,225,226,286,271,271,271,271,271,271,271,271,271,271,271,271,271,271,271,271,228,288,274,275,271,271,271,271,271,271,271,228,288,274,274,412,274,274,280,270,271,272,280,280,280,280,280,280,280,280,280,280,280,280,280,280,280,280,280,280,280,280,280,280,280,280,280,280,280,280,280,280
280,361,280,280,280,280,280,225,226,286,271,271,271,240,316,316,241,271,271,271,365,271,271,271,271,363,271,271,273,412,274,275,271,363,271,271,271,228,229,288,274,274,366,274,274,280,225,286,271,285,227,280,280,280,280,280,280,280,280,280,280,280,280,280,361,362,280,280,280,280,280,280,280,280,280,280,280,280,280,280
280,280,280,280,280,225,226,286,271,365,271,240,241,285,226,226,286,271,271,364,271,271,409,271,271,271,271,271,273,274,242,320,271,271,271,228,229,288,274,274,274,274,274,280,280,280,270,271,408,271,272,280,280,280,280,280,280,280,280,280,280,280,280,280,407,280,280,280,280,280,280,407,362,280,406,280,280,280,280,280
280,280,280,225,226,286,271,271,271,271,271,285,286,271,271,271,271,363,271,271,271,271,271,271,271,271,271,228,288,274,275,271,228,229,229,288,274,274,274,280,280,280,225,226,226,226,286,364,271,271,272,246,280,280,280,280,280,280,280,280,280,280,280,280,406,280,280,280,406,280,280,280,406,280,280,280,280,280,280,280
280,280,280,270,271,271,271,409,271,409,271,271,271,271,271,271,271,271,271,271,271,271,271,228,229,229,229,288,274,274,287,229,288,274,274,274,274,274,274,280,225,226,286,271,271,271,271,271,240,316,317,280,280,280,280,280,280,280,280,280,280,280,280,280,280,280,280,406,280,280,280,280,280,280,280,280,280,280,280,280
280,280,225,286,271,271,271,271,271,271,271,271,409,271,271,408,271,228,229,229,229,230,228,288,274,274,274,274,274,411,274,274,274,274,274,413,274,274,280,280,270,271,271,408,271,240,316,316,317,280,280,280,280,280,280,280,280,280,280,280,280,280,280,280,280,280,280,280,280,280,280,280,280,280,280,280,280,360,280,280
280,280,270,271,271,365,271,271,271,271,271,271,271,271,271,271,228,288,274,274,274,287,288,274,274,274,413,274,274,274,274,274,274,274,274,274,274,280,280,225,286,271,271,410,240,317,280,280,280,280,280,280,280,280,280,280,280,280,280,280,280,280,280,280,280,280,280,405,407,280,280,280,280,280,280,280,280,406,280,280
225,226,286,271,271,271,271,271,271,364,271,271,271,271,271,228,288,274,412,274,274,274,274,274,274,274,274,274,274,274,411,274,274,274,274,274,280,225,226,286,363,271,240,316,317,280,280,280,280,280,280,280,280,280,280,280,280,280,280,280,280,280,280,280,280,280,280,362,280,280,280,360,280,280,405,280,280,280,280,280
286,271,271,271,271,271,271,271,271,271,271,271,271,228,229,288,274,274,242,243,274,274,368,366,274,274,274,274,274,274,274,274,368,274,280,280,280,270,271,271,271,240,317,280,280,280,280,280,280,280,280,280,280,280,280,280,280,280,280,280,280,280,280,280,280,280,280,280,280,280,280,280,280,280,280,280,280,280,280,280
271,240,241,271,271,271,363,271,271,271,271,228,229,288,274,274,274,274,287,288,274,411,274,274,274,274,274,274,274,274,274,274,274,280,280,225,226,286,271,271,271,272,280,280,280,280,280,280,280,280,280,280,280,280,280,280,280,280,280,280,280,280,280,280,280,280,280,280,280,280,280,280,280,280,280,280,280,280,280,280
271,285,364,271,271,271,271,228,229,229,229,288,274,274,367,274,274,274,274,274,274,242,319,319,280,225,226,227,280,280,280,280,280,225,226,286,271,271,271,363,271,272,280,280,361,280,280,407,280,406,280,280,280,280,280,280,280,280,280,280,280,280,280,280,280,280,280,280,280,280,280,280,280,280,280,280,280,280,280,280
271,271,271,271,271,271,228,288,274,274,274,274,274,274,274,274,274,242,319,280,280,280,225,226,227,270,271,272,225,226,226,226,226,286,271,271,364,271,271,271,271,272,280,280,280,280,280,280,280,280,280,280,361,280,280,280,280,280,280,280,280,280,280,280,280,280,280,280,280,280,280,280,280,280,280,280,280,280,280,280
228,229,229,229,229,229,288,274,274,368,274,274,274,274,242,319,319,280,280,280,225,226,286,271,285,286,271,285,286,271,271,271,271,271,271,228,229,229,230,271,271,285,227,280,280,280,280,280,280,280,280,280,280,280,280,280,280,280,280,280,280,280,280,280,280,280,280,280,280,280,280,280,280,280,280,280,280,280,280,280
273,274,242,319,319,319,319,319,319,319,280,280,280,280,280,280,280,280,280,225,286,271,271,271,271,271,365,271,271,364,271,271,271,228,229,288,274,274,287,230,271,271,285,227,280,280,280,280,280,280,280,280,280,280,280,280,280,280,280,280,280,280,280,280,280,280,280,280,405,280,280,280,280,280,280,280,280,280,280,280
280,280,280,225,226,227,280,225,226,227,225,226,227,280,280,280,280,225,226,286,271,271,271,409,271,271,271,271,271,365,271,271,228,288,274,274,366,274,274,275,271,363,271,285,227,280,280,280,280,280,280,280,280,280,280,280,280,280,280,280,280,280,280,280,280,280,280,280,280,280,280,280,280,280,280,280,280,280,280,280
226,226,226,286,271,272,225,286,271,285,286,271,285,226,226,226,226,286,271,363,271,271,271,228,229,229,229,230,271,271,228,229,288,274,274,274,274,274,274,287,230,271,271,271,272,280,280,280,360,280,280,280,361,280,280,280,280,280,280,280,280,280,280,280,280,280,280,280,280,280,280,280,280,406,280,362,280,280,280,280
271,271,271,271,271,285,286,271,409,271,271,271,271,271,364,271,271,271,271,228,229,229,229,288,274,274,274,287,229,229,288,274,274,367,274,412,274,274,274,274,275,271,365,271,272,280,280,280,280,280,280,280,280,280,280,280,280,280,280,280,280,280,280,280,280,280,280,280,280,280,280,280,280,280,405,280,280,280,280,280
271,271,410,271,271,363,271,271,271,228,229,230,228,229,229,229,229,229,230,273,274,274,274,274,274,411,274,274,274,274,274,274,274,274,274,274,274,368,274,274,287,229,230,271,272,280,280,361,280,280,280,280,280,280,280,280,280,280,280,280,280,280,280,280,280,280,280,280,280,280,280,280,280,280,407,280,280,280,280,280
316,241,271,271,271,271,271,271,271,273,274,287,288,274,274,274,274,274,287,288,274,274,413,274,274,367,274,274,274,274,368,274,274,274,274,366,274,274,274,274,274,274,275,271,272,280,280,280,280,280,280,280,280,280,280,280,405,280,280,280,280,280,280,280,280,280,280,280,280,280,280,280,280,280,407,280,361,280,280,280
280,315,316,241,271,271,410,271,271,318,319,243,412,242,319,319,243,274,274,274,274,274,274,274,274,274,274,274,274,274,274,274,366,274,274,274,274,366,274,274,411,274,275,271,272,280,280,280,280,280,280,280,280,280,280,280,280,280,280,280,280,280,280,280,280,280,280,280,280,280,280,280,280,280,280,280,280,280,280,280
280,280,280,315,316,316,241,271,271,271,271,318,319,320,271,271,318,319,319,319,319,319,319,319,319,243,274,413,274,274,274,274,274,274,274,274,274,412,274,274,274,242,320,271,272,280,280,280,280,280,280,280,280,280,405,280,280,280,280,280,280,280,280,280,280,280,280,280,280,280,280,280,280,280,280,280,280,405,280,280
280,280,361,280,280,280,315,316,316,316,241,271,409,271,271,240,316,316,241,271,271,409,271,271,271,318,319,319,319,319,319,243,274,274,368,274,274,274,274,274,274,275,271,410,272,280,280,280,280,280,280,280,280,280,406,280,280,280,280,280,280,280,280,280,280,280,280,280,280,280,280,280,280,280,280,280,280,280,280,280
280,280,405,280,280,280,280,280,280,280,315,316,316,316,316,317,280,280,315,316,316,241,271,363,271,271,271,363,271,271,271,318,243,274,274,274,413,274,274,274,242,320,271,240,317,280,280,280,280,280,280,280,360,280,362,280,280,280,406,280,280,280,280,280,280,280,280,280,280,280,280,280,280,280,280,280,280,407,280,280
280,280,405,280,280,280,280,280,280,280,280,280,280,280,280,280,280,280,280,280,280,315,316,316,316,316,241,271,271,408,271,271,318,319,319,243,274,274,274,274,275,271,271,272,280,280,280,280,280,280,280,280,280,280,361,280,280,280,280,280,360,280,280,280,280,280,280,280,280,280,280,280,280,280,280,280,280,406,360,280
280,280,280,280,280,280,280,280,280,280,280,280,280,280,280,280,406,280,280,280,280,280,280,280,280,280,315,316,316,316,316,241,410,271,271,273,274,274,242,319,320,271,271,272,280,280,280,280,280,280,280,405,280,280,406,280,280,280,280,280,280,280,280,280,280,280,280,280,280,280,280,280,280,280,280,280,280,280,280,280
280,280,280,280,362,280,280,280,280,280,406,280,280,280,280,280,280,280,280,406,280,280,406,280,280,280,280,280,280,280,280,270,271,271,271,318,319,319,320,271,271,409,271,272,280,280,280,280,280,280,280,280,280,280,406,280,280,280,280,280,280,280,280,280,280,280,280,280,280,280,280,280,280,280,280,280,280,280,280,280
280,280,280,280,362,280,280,280,407,280,280,280,362,280,280,280,280,280,361,280,280,280,280,280,406,280,280,280,280,280,280,270,271,409,271,271,271,271,271,271,271,271,240,317,280,280,280,280,280,280,280,280,280,280,360,405,280,280,280,280,406,280,280,280,280,280,280,280,280,280,280,280,280,280,280,280,280,280,280,280
280,280,280,280,280,280,280,280,280,280,280,280,280,280,280,280,280,280,280,280,280,280,280,280,280,280,280,362,280,280,280,315,316,316,316,241,271,365,271,409,271,240,317,280,280,280,280,280,280,280,280,280,280,280,406,405,280,280,280,280,280,280,280,280,280,280,280,280,280,280,280,280,280,280,280,280,280,280,280,280
280,280,280,280,280,280,280,280,280,362,280,280,280,280,280,280,280,280,280,280,280,280,280,280,280,280,280,280,280,280,280,280,280,280,280,315,316,316,316,316,316,317,280,280,280,280,280,280,407,280,280,280,280,280,280,280,280,280,280,280,280,280,280,280,280,280,280,280,280,280,280,280,280,280,280,280,280,280,280,406
362,280,280,280,280,280,280,280,280,407,280,280,280,406,280,280,280,280,405,406,280,280,280,280,280,280,280,280,280,280,280,280,280,280,280,280,280,280,280,280,280,280,280,280,280,280,280,280,360,280,280,280,280,280,280,280,280,280,360,280,280,280,360,280,280,280,280,280,280,280,280,280,280,280,280,280,280,280,280,280
280,406,280,280,280,280,280,280,280,362,280,280,280,280,280,280,280,280,280,280,280,280,280,280,280,280,280,280,280,280,280,280,280,280,280,280,280,280,280,280,280,280,280,280,280,280,280,280,280,280,280,280,280,280,280,280,280,280,280,280,280,280,280,280,280,280,280,280,280,280,280,280,280,280,280,280,280,280,280,280
280,280,280,280,280,280,280,280,280,280,280,280,280,280,280,280,280,280,280,280,280,280,280,280,280,280,406,280,361,280,407,280,280,280,280,280,407,280,280,280,280,280,280,280,280,280,360,280,405,280,280,280,280,280,280,362,280,280,280,280,280,280,280,280,280,280,280,280,280,280,280,280,280,280,280,280,280,280,280,280
280,280,280,280,280,280,280,280,280,280,280,280,280,280,280,280,280,280,280,280,280,280,280,280,280,280,280,280,280,280,280,361,280,280,280,280,280,280,280,280,280,280,280,280,280,280,280,280,280,280,280,280,280,280,280,280,280,280,280,280,360,280,280,280,280,280,280,280,280,280,280,280,280,280,280,280,280,280,280,280
406,280,280,280,280,280,280,280,280,280,280,280,407,362,280,280,280,280,280,280,280,407,405,280,280,280,280,280,280,280,280,360,280,280,280,280,280,280,280,280,280,407,280,280,280,280,362,280,280,280,280,280,280,280,280,280,280,280,280,280,280,280,280,280,280,280,280,280,280,280,280,280,280,280,280,280,280,280,280,280
280,280,280,280,225,226,226,226,226,227,280,280,280,280,280,280,362,280,280,280,406,405,280,280,280,280,280,280,280,280,280,280,280,280,280,280,280,280,280,280,280,362,280,360,406,280,280,280,405,280,280,280,280,280,280,280,280,280,280,280,280,280,280,280,280,280,280,280,280,280,280,280,280,280,280,280,280,280,280,280
280,280,280,225,286,271,271,271,271,285,227,280,280,280,280,280,280,280,280,280,280,280,280,280,280,280,280,280,280,280,280,280,280,280,280,280,280,280,280,280,280,280,280,407,280,280,280,280,405,280,280,280,406,280,280,280,280,280,280,280,280,280,280,280,280,405,280,280,280,280,280,280,280,280,280,280,280,280,280,280
225,226,226,286,271,410,240,241,408,271,285,227,280,280,280,280,280,280,280,280,280,280,280,280,280,280,280,280,280,280,405,280,280,280,280,405,280,280,280,280,280,361,280,280,280,280,280,280,280,280,280,360,280,280,280,362,280,280,280,280,280,280,360,280,280,280,280,280,280,280,280,280,280,280,280,280,280,280,280,280
271,271,271,271,240,316,317,315,241,271,363,285,226,226,226,226,226,226,226,226,226,227,280,280,280,280,280,280,280,280,280,280,280,280,280,362,280,406,280,280,280,280,280,280,280,280,280,280,280,280,280,280,280,280,280,280,280,280,280,280,280,280,280,280,280,280,280,280,280,280,280,280,280,280,280,280,280,280,280,280
271,271,240,316,317,225,226,227,315,316,316,241,271,271,271,271,271,271,271,271,271,285,226,227,280,280,280,280,280,280,280,362,406,280,280,406,280,280,280,280,280,280,280,280,280,280,280,280,280,280,280,280,280,280,280,280,280,280,280,280,280,280,280,280,280,280,280,280,280,280,280,280,280,280,280,280,280,280,280,280
271,365,285,226,226,286,271,285,226,226,227,315,316,316,316,316,316,316,316,241,271,365,271,272,280,280,280,405,280,405,280,280,280,280,280,280,280,280,280,280,280,280,280,280,280,280,280,280,280,280,362,280,280,280,280,280,280,280,280,280,280,280,280,280,280,280,280,280,280,280,280,280,280,280,280,280,280,280,280,280
271,271,271,271,271,410,271,271,271,271,285,226,226,226,226,226,226,226,227,315,316,241,271,272,280,280,360,280,280,280,280,280,280,280,280,280,280,280,280,280,280,280,280,280,280,280,280,280,280,280,280,280,280,280,280,280,280,280,280,280,405,280,280,280,407,280,280,280,280,280,280,280,280,280,280,280,280,280,280,280
229,229,229,229,230,271,271,271,271,410,271,271,271,271,271,271,271,271,285,226,227,270,271,285,227,280,280,280,280,362,280,280,280,280,280,280,280,280,280,280,280,280,360,280,280,280,280,280,280,280,280,280,360,280,280,280,280,280,280,280,280,280,280,280,280,280,280,280,280,280,280,280,280,280,280,280,280,280,280,280
274,274,274,274,287,230,271,271,271,271,271,271,271,271,271,410,271,271,271,271,285,286,271,271,285,226,226,227,280,280,280,362,280,280,280,280,280,280,362,280,280,280,280,280,280,280,280,280,280,280,280,280,280,280,280,280,280,280,280,361,280,280,280,280,280,280,280,280,280,280,280,280,280,280,280,280,407,280,280,280
274,274,274,274,274,287,229,230,271,271,409,271,271,271,363,271,364,271,271,271,271,240,316,241,271,271,271,285,226,227,280,280,280,280,280,280,280,280,280,280,280,280,280,280,280,280,280,407,280,280,280,280,280,280,280,280,362,280,280,280,280,280,280,280,280,280,280,280,280,280,280,280,280,280,280,280,280,280,280,280
274,412,366,274,274,274,274,287,229,229,229,230,271,271,365,271,271,363,271,271,271,285,226,286,271,271,271,271,271,285,226,227,280,280,280,360,280,280,280,280,280,280,280,280,280,280,280,361,280,280,280,280,280,280,280,280,280,280,280,280,280,360,280,280,280,280,280,280,280,280,280,280,280,280,280,280,280,280,280,280
274,274,274,274,274,274,368,274,274,274,274,275,271,271,271,271,271,271,271,271,271,271,271,271,271,364,271,271,271,271,271,285,227,280,280,280,280,280,280,280,280,280,280,280,280,280,280,280,280,360,280,280,280,280,280,280,280,280,280,280,280,280,280,280,280,280,280,280,280,280,280,280,280,280,280,280,280,280,280,280
274,274,367,274,274,274,274,274,274,274,274,287,230,271,271,271,271,271,364,271,271,271,271,271,271,410,271,240,316,241,409,271,272,280,280,280,280,280,280,280,280,280,280,280,280,280,280,280,280,407,280,280,280,280,280,280,280,280,280,360,406,280,280,280,280,280,280,280,280,280,280,280,280,280,280,280,280,280,280,362
274,274,274,274,274,274,274,368,274,274,366,274,275,271,271,271,271,410,364,271,271,271,271,271,271,271,271,285,227,315,241,271,272,280,280,280,280,280,280,280,280,406,280,280,280,280,280,280,280,280,280,280,280,280,280,280,280,280,280,280,280,405,280,280,280,280,280,280,280,280,280,280,280,280,280,280,280,280,280,280
274,274,274,411,274,274,274,274,274,274,274,274,275,271,271,271,271,365,409,271,271,271,410,271,271,271,271,271,285,226,286,271,272,280,280,405,280,280,360,280,280,280,280,280,280,280,280,280,280,406,280,280,280,280,280,406,280,280,280,280,280,280,280,280,280,280,280,280,280,280,280,280,280,280,280,360,280,362,405,280
274,274,274,274,274,274,274,274,274,274,274,274,275,271,271,228,229,230,271,271,408,271,271,271,271,271,271,271,409,271,271,410,285,227,280,280,280,280,280,280,280,280,280,361,280,280,280,280,280,280,280,280,360,280,280,280,280,280,280,280,280,280,280,280,280,280,280,280,280,280,280,280,280,280,280,280,280,407,280,280
274,366,274,274,274,411,412,274,274,274,413,274,287,230,228,288,274,287,229,230,271,271,271,271,271,408,271,271,271,271,271,271,271,285,226,226,227,280,280,280,280,280,280,407,280,280,280,280,280,280,280,280,280,280,280,280,280,280,280,280,280,280,280,280,280,280,280,280,280,280,280,280,405,280,280,280,406,280,280,280
274,274,411,274,274,274,413,274,274,274,274,274,274,287,288,274,274,274,274,275,271,271,271,271,271,271,364,365,271,271,271,409,271,271,271,271,285,226,226,227,280,280,280,280,280,280,280,280,280,280,280,280,280,280,280,280,280,280,280,280,280,280,280,280,280,280,280,280,280,280,280,280,280,280,280,362,280,406,280,280
274,274,274,274,274,274,274,274,274,274,274,274,274,274,274,274,366,368,274,287,230,271,271,271,271,271,271,271,271,271,271,271,240,316,241,271,271,271,271,272,280,280,280,280,280,280,280,280,280,280,280,280,280,280,280,280,280,280,280,280,280,280,280,280,280,280,280,280,280,280,280,280,280,280,280,406,280,280,280,280
274,274,274,367,274,274,274,274,274,274,274,274,274,274,274,274,274,274,274,274,287,229,229,230,271,271,271,271,410,271,271,271,285,227,315,316,241,271,271,272,280,406,280,280,280,280,280,280,280,280,280,280,280,280,280,280,280,280,280,280,280,280,280,280,280,280,280,280,280,280,280,280,280,280,280,405,280,280,280,280
274,274,274,411,274,274,274,274,274,274,412,274,274,274,274,274,274,274,411,274,274,274,274,287,230,271,410,271,271,271,271,271,271,285,226,226,286,271,271,272,280,280,280,280,280,280,280,280,280,280,280,280,280,280,280,280,280,406,280,280,280,280,280,280,280,280,280,280,280,280,280,280,280,280,280,280,406,407,280,280
274,274,274,274,274,366,274,274,274,274,366,274,274,274,274,274,274,274,274,274,274,274,274,274,287,230,271,271,228,229,230,271,271,271,271,271,271,363,271,285,226,226,226,227,280,280,280,280,280,280,280,280,280,280,280,280,280,362,280,280,280,280,405,280,280,280,280,280,280,280,280,280,280,280,280,280,280,280,280,280
274,274,274,274,274,274,274,274,274,274,274,367,274,274,274,274,412,274,274,274,412,274,274,274,274,287,229,229,288,274,287,229,229,230,271,271,271,271,271,271,271,271,271,272,280,280,361,406,280,280,280,280,280,280,280,280,280,280,280,362,280,280,280,280,280,280,280,280,280,280,280,280,280,280,280,280,280,280,406,280
274,274,274,367,274,274,274,274,274,274,274,274,274,274,274,274,274,274,274,274,274,274,274,274,274,274,413,274,274,274,274,274,274,287,230,271,271,410,271,271,271,410,271,272,280,280,280,280,280,280,280,280,280,280,280,280,280,280,280,280,280,280,280,280,280,280,280,280,280,280,280,280,280,280,280,280,280,280,280,280
274,366,274,274,274,274,274,274,274,274,367,274,413,274,274,274,368,274,274,274,274,274,274,274,274,274,274,242,319,319,319,243,411,274,287,230,271,271,271,271,271,271,271,285,226,227,280,280,280,280,280,280,280,280,280,280,280,280,280,280,280,280,280,280,280,280,280,280,280,280,280,280,280,280,280,280,280,280,280,280
274,274,411,274,274,274,366,274,274,274,274,274,274,274,274,274,368,274,274,274,274,274,274,274,367,274,274,275,271,271,271,318,243,274,274,287,230,271,271,364,240,241,271,271,271,285,227,280,280,280,280,280,280,280,280,280,280,280,280,406,280,280,280,280,407,280,280,280,280,280,280,280,280,280,280,280,280,280,280,280
274,274,274,274,274,274,274,274,274,274,274,274,274,274,274,274,274,274,274,274,274,274,274,274,274,274,274,275,271,364,271,271,318,243,274,366,287,230,271,365,285,286,271,271,271,271,272,280,280,280,280,280,280,280,280,280,280,280,280,280,280,361,280,280,280,280,280,280,280,280,280,280,280,280,280,280,280,280,280,280
274,274,274,274,366,412,274,274,274,274,366,274,274,274,412,274,274,274,274,413,274,274,274,274,274,274,274,275,271,271,271,409,271,318,243,274,274,287,230,271,271,271,271,363,271,271,272,280,280,280,280,280,280,280,280,280,280,280,280,280,280,280,280,280,280,280,280,280,280,280,280,280,280,280,280,280,280,280,280,280
274,274,274,411,274,274,274,274,274,274,368,274,274,366,274,274,274,274,274,274,274,274,274,366,274,274,274,287,230,409,271,364,271,271,318,319,243,274,287,229,229,230,271,271,271,271,272,280,280,280,280,280,280,280,280,280,280,280,280,280,280,280,280,280,280,280,280,280,280,280,280,280,280,280,280,280,280,280,280,280
274,274,274,274,274,274,274,274,274,274,274,274,274,274,274,274,274,274,274,274,274,274,274,274,274,274,274,274,287,229,229,229,229,229,229,229,288,274,274,274,274,287,229,230,271,271,285,226,227,280,280,280,280,280,280,280,280,280,280,406,280,280,280,280,280,280,280,280,280,280,280,280,280,280,280,280,280,280,280,280
274,274,274,274,274,274,274,274,366,274,274,274,274,274,274,274,274,274,274,274,368,274,274,274,274,274,274,274,274,274,274,274,274,274,274,274,274,274,274,274,368,274,274,287,230,271,271,271,272,280,280,280,280,280,280,280,280,361,280,280,280,280,280,280,280,280,280,280,280,280,280,280,280,280,280,280,280,280,280,280
274,274,411,274,274,274,274,274,274,274,366,274,274,274,368,274,274,274,274,274,274,411,274,274,367,274,274,274,368,274,274,274,274,274,274,274,412,274,274,274,274,274,274,274,275,271,409,410,285,227,280,280,280,406,280,280,280,280,280,280,280,280,405,280,280,280,280,280,280,280,280,280,280,280,280,280,280,280,280,280
274,274,366,274,274,274,274,274,274,274,274,274,368,274,274,274,274,274,274,274,274,274,274,274,274,274,274,274,274,274,274,274,274,274,274,274,274,274,274,274,367,274,274,367,275,271,271,271,271,272,280,280,280,280,280,280,280,280,280,280,280,280,280,280,280,280,280,280,280,280,280,280,280,280,280,280,280,280,280,280
274,274,274,274,274,274,274,274,274,274,274,274,274,274,274,274,274,274,274,274,274,274,274,274,274,274,274,274,411,274,274,274,274,274,411,274,274,274,274,274,274,274,274,274,275,271,363,271,240,317,280,280,280,280,280,280,280,280,280,280,280,280,280,280,280,280,280,407,280,280,280,280,280,280,280,280,280,280,280,280
