55,55,55,55,55,55,0,1,61,46,46,46,60,1,1,1,1,1,1,2,55,55,55,55,55,55,55,55,55,55,55,55,55,55,55,55,55,55,55,55,55,90,16,46,46,140,46,46,140,46,46,46,46,60,1,2,55,55,55,55,0,61,46,46,60,61,46,60,61,140,46,47,55,55,55,55,55,55,55,55
55,55,55,55,55,55,45,46,46,46,183,46,46,46,46,46,46,46,46,60,1,2,55,55,55,55,55,55,55,55,55,55,55,55,55,55,55,182,55,55,55,55,90,16,184,46,15,16,46,46,46,46,46,46,46,60,1,1,1,1,61,46,46,46,183,46,46,46,184,46,46,47,55,55,55,55,55,55,55,55
55,55,55,55,55,55,45,46,46,46,140,46,46,46,46,46,46,46,46,46,46,60,2,55,55,55,55,55,55,55,55,55,55,55,55,55,55,55,55,55,55,55,55,90,16,46,60,61,46,46,46,46,15,16,46,46,46,46,46,46,46,46,46,46,139,46,46,46,46,46,46,47,55,55,55,55,55,55,55,55
55,55,55,55,55,55,45,46,46,184,46,46,46,46,46,46,46,46,46,46,46,46,60,2,55,55,55,55,55,55,55,55,55,55,55,55,55,55,55,55,55,55,55,55,90,16,46,46,15,16,46,140,60,61,46,46,46,46,46,46,46,46,46,46,46,46,139,46,139,46,15,92,55,55,55,55,55,55,55,55
55,55,55,55,0,1,61,46,46,183,46,46,46,46,46,46,46,46,46,46,46,46,46,60,1,1,1,1,1,2,55,55,55,55,55,55,55,55,55,55,55,55,55,55,55,45,46,46,60,61,139,46,46,46,46,46,46,46,46,46,46,46,46,46,46,46,46,46,46,15,92,55,55,55,55,55,55,180,55,55
55,55,55,0,61,46,46,46,185,46,46,46,46,46,46,46,46,46,46,46,46,46,46,46,46,46,46,46,46,60,1,2,55,55,55,55,55,55,55,55,55,55,55,55,55,90,16,46,46,46,46,46,185,46,46,46,46,46,46,46,46,46,46,46,46,46,15,91,91,92,55,55,55,55,55,55,55,55,55,55
55,0,1,61,46,46,46,46,46,46,46,46,46,46,46,46,46,46,46,46,46,46,46,46,46,46,46,46,46,46,46,60,1,2,55,55,55,55,55,55,55,55,55,55,55,55,90,91,91,91,91,16,140,46,46,46,46,46,46,46,184,46,46,15,91,91,92,55,55,55,55,55,55,55,55,55,55,55,55,55
55,45,46,46,15,16,46,46,140,46,46,46,46,46,46,46,46,46,46,46,46,46,46,46,46,46,46,46,46,46,46,46,46,60,2,55,55,55,55,55,55,55,55,55,55,55,55,55,55,55,55,90,16,46,46,46,46,46,46,46,46,184,15,92,55,55,55,55,55,55,55,55,55,55,55,55,55,55,55,55
55,45,46,15,92,45,46,46,183,46,46,46,46,46,46,46,46,46,46,46,46,46,46,46,46,46,46,46,46,46,46,46,46,46,60,2,55,55,55,55,55,55,55,55,55,55,55,136,55,55,55,55,45,46,46,46,46,46,46,184,46,15,92,55,55,55,55,55,55,55,55,55,55,55,55,55,55,55,55,55
55,45,46,47,55,45,46,46,139,183,46,46,46,46,46,46,46,46,46,46,46,46,46,46,46,46,46,46,46,46,46,46,46,46,46,60,1,1,2,55,55,55,55,55,55,55,55,55,55,55,55,55,90,16,46,46,46,183,46,46,15,92,55,55,55,55,55,55,55,55,55,55,55,55,55,55,55,55,55,55
55,45,46,60,1,61,46,139,46,46,184,183,46,46,46,46,46,46,46,46,46,46,46,46,46,46,46,46,46,46,46,46,46,46,46,46,46,46,60,1,1,2,55,55,55,55,55,55,55,136,55,55,55,90,91,91,91,91,91,91,92,55,55,55,55,55,55,55,55,55,55,55,180,55,55,55,55,55,55,55
55,45,46,46,46,46,46,46,46,46,46,46,184,46,46,183,46,46,46,46,46,46,46,46,46,46,46,46,46,46,46,46,46,46,46,46,46,46,46,46,46,60,1,1,2,55,55,55,55,55,55,55,55,55,55,55,55,55,55,55,55,55,55,55,55,55,55,55,55,55,55,55,55,55,55,55,55,55,55,55
0,61,46,46,46,46,46,46,15,91,16,46,46,46,46,46,46,46,46,46,46,46,46,46,46,46,46,46,46,46,46,46,46,46,46,46,46,46,46,46,46,46,46,46,60,2,55,55,55,55,55,55,55,55,55,55,55,55,55,55,55,55,55,55,55,55,55,55,55,55,55,55,55,55,55,55,55,55,55,55
45,46,46,46,15,16,46,46,60,2,90,16,46,138,46,46,46,184,46,15,16,46,46,46,46,46,15,91,16,46,46,46,183,139,140,46,46,46,140,46,46,46,46,46,46,47,55,55,55,55,55,55,55,55,55,55,55,55,55,55,55,55,55,55,55,55,55,55,55,55,55,55,55,55,55,55,55,55,55,55
45,46,46,46,47,45,46,46,46,47,55,90,91,91,16,46,46,46,46,60,61,46,46,185,138,46,60,1,61,184,46,46,46,46,184,46,138,46,184,140,46,46,46,46,15,92,55,55,55,55,55,55,55,55,55,55,55,55,55,55,55,55,55,55,55,55,55,55,55,55,55,135,55,55,55,55,55,55,505,505
45,46,46,46,47,90,16,46,46,60,2,55,55,55,90,91,91,91,16,46,46,46,46,46,46,46,46,139,184,183,184,185,46,46,46,46,184,140,46,140,46,46,139,183,60,2,55,55,55,55,55,55,55,55,55,55,55,55,55,55,55,55,55,55,55,55,55,55,55,55,55,55,55,55,55,55,55,55,505,505
45,46,46,15,92,55,45,46,46,46,47,55,55,55,55,55,55,55,90,91,91,91,91,91,91,91,91,91,91,91,91,91,91,91,91,91,91,91,91,91,91,16,46,138,46,60,2,55,55,55,55,55,55,55,55,55,55,55,55,55,55,55,55,55,55,55,55,55,55,55,55,55,55,55,55,55,55,55,505,505
45,46,46,60,2,55,45,46,46,46,60,2,55,55,55,55,55,55,55,55,55,55,55,55,55,55,55,55,55,55,55,55,55,55,55,55,55,55,55,55,55,45,46,140,46,46,60,1,2,55,55,55,55,55,55,55,55,55,55,55,55,55,55,55,55,181,55,55,55,55,55,55,55,55,55,55,55,55,505,505
90,16,46,46,47,55,90,16,46,46,46,47,55,55,55,55,55,55,55,55,55,55,55,55,55,182,55,55,55,55,55,55,55,55,55,55,55,55,55,55,55,45,46,138,184,46,140,46,60,1,1,1,2,55,55,55,55,55,55,55,55,55,55,55,55,55,55,55,55,55,55,55,55,55,55,55,505,505,505,450
55,45,46,46,60,2,55,45,46,46,46,60,2,55,55,55,55,55,55,55,55,55,55,55,55,55,55,55,55,181,55,55,55,55,55,55,55,55,55,55,55,90,91,16,46,46,46,140,183,183,46,46,47,55,55,55,55,55,55,55,55,55,55,55,55,55,55,55,55,55,55,55,55,55,505,505,505,450,451,511
55,90,16,46,46,47,55,45,46,46,46,46,47,55,55,55,55,55,55,55,55,180,55,55,55,55,137,55,55,55,55,55,55,55,55,55,55,55,55,55,55,55,55,90,91,91,91,91,91,91,91,91,92,55,55,55,55,55,55,55,55,55,55,55,55,55,55,55,55,55,55,55,55,55,505,505,505,495,496,496
55,55,45,46,46,60,2,90,16,46,46,46,60,2,55,55,55,55,55,55,55,55,55,181,55,55,55,180,55,55,55,55,55,55,55,55,55,55,55,55,55,55,55,55,55,55,55,55,55,55,55,55,55,55,55,55,55,55,55,55,55,55,55,55,55,180,55,55,55,55,55,55,55,55,55,505,505,495,496,496
55,55,90,16,46,46,47,55,45,46,46,46,46,47,55,55,55,55,55,55,55,55,55,55,55,55,55,55,55,55,55,55,55,55,55,55,55,55,55,55,55,55,55,55,55,55,55,55,55,55,55,55,55,55,55,55,55,55,55,55,55,55,55,55,55,55,55,55,55,55,55,55,55,55,55,505,505,495,496,496
55,55,55,90,16,46,60,2,45,46,46,46,46,60,2,55,55,55,55,55,55,55,55,55,55,55,55,55,55,55,55,55,55,55,55,55,55,55,55,55,55,55,55,55,55,55,55,55,55,55,55,55,55,55,55,55,55,55,55,55,55,55,55,55,55,55,55,55,55,55,55,55,55,55,55,505,505,540,466,496
55,55,55,55,45,46,46,47,90,16,46,46,46,46,47,55,55,55,181,55,55,55,55,55,55,55,182,55,55,55,55,55,55,55,55,55,55,55,55,55,55,55,55,55,55,55,55,55,55,55,55,55,55,55,55,55,55,55,55,55,55,55,55,55,180,55,55,180,55,55,55,55,55,55,55,505,505,505,495,496
55,55,55,55,90,16,46,60,2,90,16,46,46,46,60,2,55,55,55,55,55,55,55,55,55,55,55,55,55,55,55,55,55,55,55,55,55,55,55,55,55,55,55,55,55,55,55,55,55,55,55,55,55,55,55,55,55,55,55,55,55,55,55,55,55,55,55,181,55,55,55,55,55,55,55,55,505,450,511,496
55,55,55,55,55,45,46,46,60,2,45,46,46,46,46,47,55,55,55,55,55,55,55,55,55,55,55,55,55,55,55,55,55,55,55,55,55,55,55,55,55,55,55,55,55,55,55,55,55,55,55,55,55,55,55,55,55,55,55,55,55,55,55,55,55,55,55,55,55,55,55,55,55,55,55,55,505,495,496,496
55,55,55,55,55,90,16,46,46,47,45,46,46,46,138,47,55,55,55,55,55,55,55,55,55,181,55,55,55,55,55,55,55,55,55,55,55,55,55,55,55,55,55,55,55,55,55,55,55,55,55,55,55,55,55,55,55,55,137,55,55,55,55,55,55,55,137,55,55,55,55,55,55,55,55,55,505,495,496,496
55,55,55,55,55,55,90,16,46,60,61,46,138,138,138,60,2,55,55,55,55,55,55,55,55,55,55,55,55,55,55,55,55,55,55,55,55,55,55,55,55,55,55,55,55,55,55,55,55,55,55,55,55,55,55,55,55,55,55,55,55,55,55,55,55,55,55,55,55,55,55,55,55,55,55,55,505,495,496,496
55,55,55,55,55,55,55,45,46,46,46,46,46,46,46,46,47,55,55,55,136,55,55,55,55,55,55,55,55,55,182,55,55,55,55,55,55,55,55,55,55,55,55,137,135,55,55,55,55,55,55,55,55,55,55,55,55,55,55,55,55,55,55,55,55,55,55,55,55,55,55,55,55,55,55,55,505,540,466,496
55,55,55,55,55,55,55,90,16,46,46,46,185,46,46,184,60,2,55,55,55,55,55,55,55,55,55,55,55,55,55,55,55,55,55,55,55,55,55,55,55,55,55,55,55,55,55,55,55,55,55,55,55,55,55,55,55,55,55,55,55,55,55,55,55,55,55,182,55,137,55,55,55,55,55,55,505,505,495,496
55,55,55,55,55,55,55,55,90,91,16,46,46,46,46,46,46,47,55,55,55,55,55,55,55,55,55,55,55,55,55,55,55,55,55,55,55,55,55,55,55,55,55,55,55,181,55,55,55,137,55,55,55,55,55,55,55,55,55,55,55,137,55,180,55,55,55,55,55,55,55,55,55,55,55,55,505,450,511,634
55,55,55,55,55,55,55,55,55,55,90,16,46,46,46,46,185,47,55,55,55,55,55,55,180,55,55,55,55,55,55,55,55,55,55,55,55,137,55,55,55,55,137,55,55,55,55,55,135,55,55,55,55,55,55,182,55,55,55,55,180,55,55,55,136,55,55,55,55,55,55,55,55,55,55,55,505,495,496,589
55,55,55,55,55,55,55,55,55,55,55,90,16,46,46,46,46,60,2,55,55,55,55,55,55,55,55,55,55,55,55,55,55,55,55,55,55,55,55,55,55,55,55,55,55,55,55,55,55,55,55,55,55,55,55,55,137,55,55,55,55,55,55,55,55,55,55,55,55,55,55,55,55,55,55,55,505,495,496,496
55,55,55,55,55,55,55,55,55,55,55,55,90,16,46,46,138,46,47,55,55,55,55,55,55,55,55,55,55,55,137,55,55,55,55,55,55,55,55,55,55,55,55,55,55,55,55,55,55,55,55,55,55,55,55,55,55,55,55,55,55,55,55,55,55,55,55,55,55,55,55,55,55,55,55,55,505,495,496,633
55,55,55,55,55,55,55,55,55,55,55,55,55,90,16,46,140,184,60,2,55,55,55,55,55,55,55,55,55,55,55,55,55,55,55,55,55,55,55,55,55,55,55,55,55,55,55,55,55,55,55,55,55,55,55,55,55,182,55,55,55,55,55,55,55,55,55,55,55,55,55,55,55,55,55,55,56,540,466,496
55,55,55,55,55,55,55,55,55,55,55,55,55,55,90,16,184,139,139,47,55,55,55,55,55,55,55,55,55,55,55,55,55,55,55,55,55,55,55,55,137,55,55,55,55,55,55,55,55,55,55,55,55,55,55,55,55,55,55,55,55,55,55,55,55,55,55,55,55,55,55,55,55,55,55,55,22,505,540,466
55,55,55,55,55,55,55,55,55,55,55,55,55,55,55,45,46,46,140,47,55,55,55,55,55,55,55,55,55,55,55,55,55,55,55,55,55,55,55,55,55,55,55,55,55,55,55,55,55,55,55,55,55,55,55,55,55,55,55,55,55,55,55,55,55,55,55,55,55,55,55,55,55,55,55,55,55,55,505,495
55,55,55,55,55,55,55,55,55,55,55,55,55,55,55,90,16,46,138,60,2,55,55,55,55,55,55,55,137,55,55,55,55,135,55,55,55,55,55,55,55,55,55,55,55,135,55,55,55,55,55,55,55,55,55,55,55,55,55,55,135,182,55,55,55,55,55,55,55,55,55,55,55,55,55,55,55,55,505,540
55,55,55,55,55,55,55,55,55,55,55,55,55,55,55,55,90,16,46,185,60,2,55,55,55,55,137,55,55,55,55,55,55,136,55,55,55,55,55,55,55,55,55,55,55,55,55,55,55,55,55,55,55,55,55,55,55,55,55,55,55,55,55,55,55,55,55,55,180,55,55,55,55,55,55,55,55,55,55,505
55,55,55,55,55,55,55,55,55,55,55,55,55,55,55,55,55,45,46,46,46,60,2,55,55,55,55,55,55,55,55,55,55,55,55,55,55,55,55,55,55,55,55,55,55,55,55,55,55,55,55,55,55,55,55,55,55,55,55,55,55,55,55,55,55,55,55,55,55,55,55,55,55,0,1,2,55,55,55,56
55,55,55,55,55,55,55,55,55,55,55,55,55,55,55,55,55,90,91,16,46,140,60,2,55,181,55,55,55,55,55,55,55,55,55,55,55,55,55,55,55,55,55,55,55,55,55,55,55,55,55,55,55,55,55,55,55,55,55,55,55,55,55,55,55,55,55,55,55,55,55,55,55,45,46,47,55,55,55,22
55,55,55,55,55,55,55,55,55,55,55,55,55,55,55,55,55,55,55,90,16,46,140,47,55,181,55,55,55,55,55,55,55,55,55,55,55,55,55,55,55,55,55,55,55,55,55,55,55,55,55,181,55,55,55,55,55,55,55,55,55,55,55,55,55,55,55,55,55,55,55,55,55,45,46,60,2,55,55,55
55,55,55,55,55,55,55,55,55,55,55,55,55,55,55,55,55,55,55,55,90,16,46,47,55,55,55,55,55,55,55,55,55,55,55,55,55,55,55,55,55,55,55,55,55,55,55,55,55,55,55,55,55,55,55,55,55,55,55,55,55,55,55,55,55,55,55,55,137,55,55,55,55,45,139,46,47,55,55,55
55,55,55,55,55,55,55,55,55,55,55,55,55,55,55,55,55,55,55,55,55,45,140,47,55,55,55,55,55,55,55,55,55,55,55,55,55,55,55,55,55,55,55,55,182,55,55,55,55,55,55,55,55,55,55,55,55,55,55,55,55,55,55,55,55,55,55,55,55,55,55,55,55,45,46,46,47,55,55,55
55,55,55,55,55,55,55,55,55,55,55,55,55,55,55,55,55,55,55,55,55,45,185,47,55,55,55,55,55,181,55,136,55,135,55,55,55,55,55,55,55,55,55,55,55,55,55,55,55,55,55,55,180,55,55,55,55,55,55,55,55,55,55,55,55,55,55,55,55,55,55,55,55,45,46,46,47,55,55,55
55,55,55,55,55,55,55,55,55,55,55,55,55,55,55,55,55,55,55,55,55,45,46,47,55,55,55,55,55,55,55,55,55,55,55,55,180,55,55,55,55,55,55,55,55,55,55,55,55,55,55,55,55,55,55,55,55,55,55,55,135,55,55,55,55,55,55,55,55,55,55,55,0,61,46,46,47,55,55,55
55,55,55,55,55,55,55,55,55,55,55,55,55,55,55,55,55,55,55,55,55,45,46,60,2,55,55,55,55,55,55,55,55,55,55,55,137,55,55,55,55,55,55,55,55,55,55,55,55,55,55,55,55,55,55,55,55,136,55,55,135,55,55,55,55,55,136,55,55,55,55,55,45,46,185,46,47,55,55,55
55,55,55,55,55,55,55,55,55,55,55,55,55,55,55,55,55,55,55,55,55,90,16,46,60,1,2,55,55,55,55,55,55,182,55,55,55,55,55,55,55,55,55,55,55,55,55,55,55,55,55,55,55,55,180,55,55,55,55,55,55,55,55,55,55,55,55,55,55,55,55,55,45,46,46,46,505,55,55,55
55,55,55,55,55,55,55,55,55,55,55,55,55,55,55,55,55,55,55,55,55,55,45,46,139,140,60,1,2,55,55,55,55,55,55,55,55,55,55,55,55,55,182,55,55,55,55,55,55,55,55,55,55,55,55,55,55,55,55,55,55,55,55,55,55,55,55,55,55,55,0,1,61,138,138,15,505,505,55,55
55,55,55,55,55,55,55,55,55,55,55,55,55,55,55,55,55,55,55,55,55,55,90,16,183,139,138,46,47,55,55,55,55,55,55,55,55,55,55,136,55,55,55,55,55,55,55,137,55,55,182,55,55,55,55,180,55,55,55,55,55,55,55,55,55,55,55,55,55,55,45,46,46,46,15,92,505,505,55,55
55,55,55,55,55,55,55,55,55,55,55,55,55,55,55,55,55,55,55,55,55,55,55,45,46,46,46,46,60,2,55,55,55,55,55,55,55,55,55,55,55,55,55,55,55,55,55,55,55,55,55,55,55,55,55,55,55,55,55,55,55,55,55,55,55,137,55,55,55,55,90,16,46,46,47,55,505,505,55,55
55,55,55,55,55,55,55,55,55,55,55,55,55,55,55,55,55,55,55,55,55,55,55,45,46,46,46,185,46,47,55,55,55,55,55,55,55,55,55,55,55,55,55,55,55,55,55,55,135,55,55,55,55,55,55,55,55,55,55,55,55,55,55,55,55,55,55,55,55,55,0,61,46,46,47,505,505,505,55,55
55,55,55,55,55,55,55,55,55,55,55,55,55,55,55,55,55,55,55,55,55,55,55,90,16,46,138,139,46,47,55,55,55,55,182,55,55,55,55,55,55,55,55,55,55,55,55,55,55,55,55,55,55,55,55,55,55,55,55,137,55,55,55,55,55,55,55,55,55,0,61,46,46,15,92,505,505,505,55,55
55,55,55,55,55,55,55,55,55,55,55,55,55,55,55,55,55,55,55,55,55,55,55,55,90,91,16,46,46,60,2,55,55,55,55,55,55,55,55,55,55,55,55,55,55,55,55,55,55,55,55,55,55,55,55,55,55,55,55,55,55,55,55,55,55,55,55,55,55,45,46,46,15,92,505,505,505,505,505,55
55,55,55,55,55,55,55,55,55,55,55,55,55,55,55,55,55,55,55,55,55,55,55,55,55,55,90,16,46,46,47,55,55,55,55,55,55,55,55,55,55,55,55,55,55,55,55,55,55,55,55,55,55,55,55,55,55,55,55,55,55,55,55,55,55,55,55,55,55,45,46,15,92,55,505,505,505,505,55,55
55,55,55,55,55,55,55,55,55,55,55,55,55,55,55,55,55,55,55,55,55,55,55,55,55,55,55,45,138,46,47,55,55,55,55,55,55,55,55,55,55,55,55,55,55,55,55,55,55,55,55,55,55,55,55,55,55,55,55,55,55,55,55,55,55,55,55,55,0,61,46,47,55,505,450,451,452,505,505,55
55,55,55,55,55,55,55,55,55,55,55,55,55,55,55,55,55,55,55,55,55,55,55,55,55,55,55,45,183,138,47,55,55,55,55,55,55,55,55,55,55,55,55,55,180,55,55,137,55,55,55,55,55,55,55,55,55,55,55,55,55,55,55,55,55,55,0,1,61,46,46,47,505,450,511,496,510,452,505,55
55,55,55,55,55,55,55,55,55,55,55,55,55,55,55,55,55,55,55,55,55,55,55,55,55,55,55,45,46,139,47,55,55,55,55,55,55,55,55,55,181,55,55,55,55,55,181,182,55,55,55,55,55,55,55,55,55,55,55,55,55,55,55,55,55,0,61,46,46,46,15,92,450,511,496,496,496,497,505,55
55,55,55,55,55,55,55,55,55,55,55,55,55,55,55,55,55,55,55,55,55,55,55,55,55,55,55,45,46,46,47,55,55,55,55,55,55,55,55,55,55,55,55,55,55,55,55,55,55,55,55,55,55,55,55,55,55,55,55,55,55,55,55,55,0,61,46,46,46,15,92,450,511,496,589,496,496,497,505,55
55,55,55,55,55,55,55,55,55,55,55,55,55,55,55,55,55,55,55,55,55,55,55,55,55,55,55,45,46,46,60,2,55,55,55,55,55,55,55,55,55,55,55,55,55,55,55,55,55,55,55,55,55,181,55,55,55,55,55,55,55,55,0,1,61,46,46,46,15,92,450,511,496,496,496,496,496,497,505,100
55,55,55,55,55,55,55,55,55,55,55,55,55,55,55,55,55,55,55,55,55,55,55,55,55,55,55,90,91,16,46,47,55,55,55,55,55,55,55,55,55,55,55,55,55,55,55,55,55,55,55,55,55,55,55,55,137,55,55,55,55,55,45,46,46,46,46,15,92,450,511,496,496,496,496,633,635,510,451,451
55,55,55,55,55,55,55,55,55,55,55,55,55,55,55,55,55,55,55,55,55,55,55,55,55,55,55,55,55,45,46,47,55,55,55,55,55,55,55,55,55,181,55,55,55,55,55,55,55,55,55,55,180,55,55,55,55,55,55,55,55,0,61,46,46,46,15,92,450,511,496,496,496,496,496,496,496,496,496,496
55,55,55,55,55,55,55,55,55,55,55,55,55,55,55,55,55,55,55,55,55,55,55,55,55,55,55,55,55,45,46,47,55,55,55,55,55,55,55,55,55,55,55,55,55,55,55,55,55,55,55,55,55,55,55,55,55,55,55,55,55,45,138,46,15,91,92,450,511,496,589,496,496,496,496,496,496,496,496,496
55,55,55,55,55,55,55,55,55,55,55,55,55,55,55,55,55,55,55,55,55,55,55,55,55,55,0,1,2,45,46,47,55,55,55,55,55,55,55,55,55,135,55,55,55,55,55,55,55,55,55,55,55,55,55,55,55,55,55,55,0,61,46,15,92,450,451,511,496,496,589,496,496,496,496,496,496,496,496,496
55,55,55,55,55,55,55,55,55,55,55,55,55,55,55,55,55,55,55,55,55,55,55,55,55,55,45,46,60,61,46,47,55,55,55,55,182,55,55,55,55,55,55,55,55,55,55,55,55,55,55,55,55,55,55,55,55,55,55,0,61,46,15,92,450,511,496,496,633,496,496,496,496,496,496,496,496,496,588,496
55,55,55,55,55,55,55,55,55,55,55,55,55,55,55,55,55,55,55,55,55,55,55,55,55,55,45,185,46,46,46,47,55,182,55,55,55,55,55,55,55,55,55,55,55,55,55,55,55,55,55,55,55,55,55,55,55,0,1,61,46,15,92,450,511,496,496,496,496,496,496,496,496,496,496,496,496,496,496,590
55,55,55,55,55,55,55,55,55,55,55,55,55,55,55,55,55,55,55,55,55,55,55,55,55,0,61,46,140,140,15,92,55,180,55,55,55,55,55,181,55,55,55,55,55,55,55,55,55,55,55,55,55,55,55,55,0,61,46,46,15,92,450,511,589,496,496,496,496,496,496,496,496,496,496,496,496,496,496,496
55,55,55,55,55,55,55,55,55,55,55,55,55,55,55,55,55,55,55,55,55,55,55,55,0,61,46,46,15,91,92,55,55,55,180,55,55,55,55,55,55,55,55,55,55,55,55,55,55,55,55,55,55,55,55,55,45,46,138,140,47,450,511,633,496,496,496,496,496,496,496,496,496,496,496,496,496,496,496,496
55,55,55,55,55,55,55,55,55,55,55,55,55,55,55,55,55,55,55,55,55,55,55,55,45,46,140,46,47,55,55,55,55,55,55,136,55,55,55,55,55,55,55,55,55,55,55,55,55,55,55,55,55,55,55,55,45,46,46,15,92,495,496,496,496,496,496,496,496,496,496,496,496,496,496,496,496,496,496,496
55,55,55,55,55,55,55,55,55,55,55,55,55,55,55,55,55,55,55,55,55,55,55,0,61,46,46,15,92,55,55,55,55,55,55,55,55,55,55,55,55,55,55,55,55,55,55,55,55,55,55,55,55,55,55,0,61,140,15,92,450,511,496,496,496,496,496,496,496,496,496,496,496,496,590,496,496,496,496,496
55,55,55,55,55,55,55,55,55,55,55,55,55,55,55,55,55,55,55,55,55,55,55,45,46,46,15,92,55,55,55,55,55,55,55,55,55,55,55,55,55,55,55,55,55,55,55,55,55,55,55,55,0,1,1,61,46,15,92,450,511,496,496,496,496,496,496,496,496,496,496,496,496,496,496,496,496,496,496,496
55,55,55,55,55,55,55,55,55,55,55,55,55,55,55,55,55,55,55,55,55,55,55,45,185,15,92,55,55,55,55,55,55,55,55,55,55,55,55,182,55,55,55,55,55,55,55,55,55,55,55,55,45,46,46,138,46,47,450,511,496,496,496,496,496,496,496,496,496,496,496,496,496,496,496,496,496,496,496,496
55,55,55,55,55,55,55,55,55,55,55,55,55,55,55,55,55,55,55,55,55,55,0,61,184,47,55,55,55,55,55,55,55,55,55,55,55,55,55,55,55,55,55,55,55,55,55,55,55,55,55,55,45,46,46,46,15,92,495,496,496,496,496,496,496,496,496,496,496,496,496,496,496,496,496,496,496,496,496,496
55,55,55,55,55,55,55,55,55,55,55,55,55,55,55,55,55,55,55,55,55,0,61,46,138,47,55,55,55,55,55,55,55,55,55,55,55,55,55,55,55,55,55,136,55,55,182,55,55,55,0,1,61,46,46,15,92,450,511,496,496,496,496,496,496,496,496,496,496,496,496,496,496,496,635,496,496,496,496,496
55,55,55,55,55,55,55,55,55,55,55,55,55,55,55,55,55,55,55,55,0,61,140,46,46,47,55,55,55,55,55,55,55,55,55,55,55,55,55,55,55,55,55,137,55,55,55,55,55,55,45,46,46,138,46,47,450,511,496,496,496,496,496,496,496,496,496,496,496,496,496,496,496,633,496,496,496,496,496,496
55,55,55,55,55,55,55,55,55,55,55,55,55,55,55,55,55,55,55,55,45,46,46,46,46,47,55,55,55,55,55,55,55,55,55,55,55,55,55,55,55,55,55,55,55,55,55,55,55,0,61,46,140,46,15,92,495,496,496,496,496,496,496,496,496,496,496,496,496,496,496,496,496,496,496,496,496,496,496,496
55,55,55,55,55,55,55,55,55,55,55,55,55,55,55,55,55,55,55,55,45,46,46,46,15,92,55,55,55,55,55,55,55,55,55,55,181,55,55,55,55,55,55,55,137,55,55,55,0,61,46,46,46,15,92,450,511,496,496,496,496,496,496,496,496,496,496,496,496,496,496,496,496,496,496,496,496,496,496,496
55,55,55,55,55,55,55,55,55,55,55,55,55,55,55,55,55,55,0,1,61,46,46,46,47,55,55,55,55,55,55,55,55,55,182,55,135,55,55,55,180,55,55,55,55,55,55,0,61,46,46,46,15,92,450,511,496,496,496,496,496,496,496,496,496,496,496,496,496,496,496,496,496,496,496,496,496,496,496,496
55,55,55,55,55,55,55,55,55,55,55,55,55,55,55,55,55,0,61,46,46,139,15,91,92,55,55,55,55,182,55,55,55,55,55,55,55,55,55,55,55,55,55,55,55,0,1,61,46,46,15,91,92,450,511,496,496,496,496,496,496,496,496,496,496,496,496,496,496,496,496,496,496,496,496,496,496,496,496,496
