46,15,16,46,46,46,46,46,46,46,46,46,46,46,46,46,46,46,46,46,46,46,46,46,46,46,46,46,46,46,46,46,46,46,46,46,46,46,46,46,46,46,46,46,46,46,46,46,46,46,46,46,46,46,46,46,46,46,46,46,46,46,46,46,46,46,46,46,46,46,46,46,46,46,46,46,46,47,0,61
46,60,61,46,46,46,46,46,46,46,46,46,46,46,46,46,46,46,46,46,46,46,46,46,46,46,46,46,46,46,46,46,46,46,46,46,46,46,46,46,46,46,46,46,46,46,46,46,46,46,46,46,46,46,46,46,46,46,46,46,46,46,46,46,46,46,46,46,46,46,46,46,46,46,46,46,46,47,45,46
46,46,46,46,46,46,46,46,46,46,46,46,46,46,46,46,46,46,46,46,46,46,46,46,46,46,46,46,46,46,46,46,46,46,46,46,46,46,46,46,46,46,46,46,46,46,46,46,46,46,46,46,46,46,46,46,46,46,46,46,46,46,46,46,46,46,46,46,46,46,46,46,46,139,46,46,46,47,45,140
46,46,46,46,46,46,46,46,46,46,46,46,46,46,46,46,46,46,46,46,46,46,46,46,46,46,46,46,46,46,46,46,46,46,46,46,46,46,46,46,46,46,46,46,46,46,46,46,46,46,46,46,46,46,46,46,46,46,46,46,46,46,46,46,46,46,46,46,46,46,46,46,46,46,46,46,15,92,45,15
46,46,46,46,46,46,46,46,46,46,46,46,46,46,46,46,46,46,46,46,46,46,46,46,46,46,46,46,46,46,46,46,46,46,46,46,46,46,46,46,46,46,46,46,46,46,46,46,46,46,46,46,46,46,46,46,46,46,46,46,46,46,46,46,46,46,46,46,46,46,46,46,46,46,46,15,92,0,61,47
46,46,46,46,46,46,46,46,46,46,46,46,46,46,46,46,46,46,46,46,46,46,46,46,46,46,46,46,46,46,46,46,46,46,46,46,46,46,46,46,46,46,46,46,46,46,46,46,46,46,46,46,46,46,46,46,46,46,46,46,46,46,46,46,46,46,46,46,46,46,138,46,46,15,91,92,0,61,15,92
46,46,46,46,46,46,46,46,46,46,46,46,46,46,46,46,46,46,46,46,46,46,46,46,46,46,46,46,46,46,46,46,46,46,46,46,46,46,46,46,46,46,46,46,46,46,46,46,46,46,46,46,46,46,46,46,46,46,46,46,46,46,46,46,46,46,46,46,46,46,138,46,140,60,1,1,61,15,92,55
46,46,46,46,46,46,46,46,46,46,46,46,46,46,46,46,46,46,46,46,46,46,46,46,46,46,46,46,46,46,46,46,46,46,46,46,46,46,46,46,46,46,46,46,46,46,46,46,46,46,46,46,46,46,46,46,139,46,46,46,46,46,46,46,185,46,184,46,183,184,46,46,46,46,46,46,46,47,55,55
46,46,46,46,46,46,46,46,46,46,46,46,46,46,46,46,46,46,46,46,46,46,46,46,46,46,46,46,46,46,46,46,46,46,46,46,46,46,46,46,46,46,46,46,46,46,46,46,46,46,46,46,46,46,46,46,46,46,46,46,15,91,16,46,46,46,46,46,46,46,46,46,46,46,15,91,91,92,55,55
46,46,46,46,46,46,46,46,46,46,46,46,46,46,46,46,46,46,139,185,46,15,16,46,46,46,46,46,46,46,46,46,46,46,46,183,184,46,46,46,46,46,46,46,46,46,184,139,46,46,46,46,46,46,46,46,15,91,91,91,92,0,61,46,46,46,46,46,46,46,46,46,46,15,92,55,55,55,55,55
46,46,46,15,16,46,183,183,139,46,15,91,16,46,46,46,46,46,46,46,46,60,61,184,138,46,46,138,183,140,46,46,46,46,46,46,46,46,46,46,46,139,46,46,46,46,46,184,183,185,46,46,46,46,46,46,60,1,1,1,1,61,46,46,15,91,91,16,46,15,91,91,91,92,181,136,55,55,55,55
46,46,46,60,61,140,46,46,15,91,92,55,90,91,91,91,91,91,91,91,91,91,91,91,16,46,46,46,46,46,46,46,46,46,139,15,91,91,91,91,16,46,46,46,46,46,46,46,46,46,46,15,91,91,16,46,46,46,185,184,46,46,15,91,92,55,55,90,91,92,55,55,55,55,55,55,55,55,55,55
138,46,46,46,46,46,15,91,92,55,55,55,55,55,55,55,55,55,55,55,55,55,55,55,90,16,46,46,46,15,91,91,91,91,91,92,55,55,55,55,90,91,91,91,91,91,91,91,91,91,91,92,55,55,90,91,91,91,91,91,91,91,92,55,55,55,55,55,55,55,55,55,55,55,55,55,55,55,55,55
46,46,15,91,91,91,92,55,181,55,55,180,55,55,55,55,55,55,55,55,55,55,55,55,55,90,91,91,91,92,55,55,55,55,55,181,55,55,55,55,55,55,55,55,55,55,55,55,55,55,55,55,55,55,55,55,55,55,55,55,55,55,55,55,55,55,55,55,55,55,55,55,55,55,55,55,55,55,135,55
46,15,92,55,55,55,55,55,182,55,55,55,55,55,55,55,55,55,137,55,55,55,136,55,55,55,55,55,55,55,55,55,55,55,55,55,55,55,55,55,55,55,55,55,55,55,55,180,55,55,55,55,55,55,55,55,55,55,55,55,55,55,55,55,55,55,55,55,181,55,55,55,55,136,55,55,55,55,55,55
91,92,55,55,55,55,55,55,55,55,180,55,55,55,55,55,55,55,55,55,55,55,55,55,55,55,55,55,55,55,55,55,55,136,55,55,55,55,55,180,182,55,55,55,55,55,55,55,55,55,55,55,55,55,55,55,55,55,55,55,55,55,55,55,181,55,55,55,55,55,55,55,55,55,55,55,55,55,55,55
55,55,55,55,136,55,135,55,55,55,55,180,55,55,135,55,55,55,55,55,55,55,55,135,55,55,55,55,55,55,55,55,55,55,55,55,55,55,55,55,55,55,55,55,55,55,182,55,55,55,55,55,55,55,55,55,137,55,55,135,55,55,55,55,55,55,55,55,55,55,55,55,55,55,55,55,55,55,55,55
55,55,55,136,55,55,55,55,55,55,55,181,55,55,182,55,55,55,55,55,55,55,55,55,55,55,55,55,55,55,55,55,55,55,55,55,55,55,55,55,55,55,55,55,55,55,55,55,135,55,55,55,55,55,55,55,55,55,55,136,55,55,55,55,55,55,55,55,55,55,55,55,55,55,55,55,182,55,55,55
55,55,55,182,55,55,55,55,55,55,55,55,55,55,55,55,55,55,136,55,55,55,55,55,55,55,55,55,55,55,55,55,55,55,55,55,55,55,55,55,55,55,55,55,55,181,55,55,55,55,55,55,55,55,55,55,55,55,55,55,55,55,55,55,55,55,55,55,55,55,55,55,55,55,55,55,55,55,55,55
55,182,182,55,55,55,55,55,55,55,55,55,55,55,55,55,55,55,55,55,55,55,55,55,55,55,55,55,55,55,55,55,55,55,55,55,55,55,55,135,55,55,55,55,55,55,55,55,55,55,55,55,55,135,181,55,55,55,55,55,55,55,55,55,55,55,55,55,180,55,55,181,55,55,55,55,55,55,55,180
55,55,55,55,135,135,136,55,55,55,180,55,55,55,55,55,181,55,55,55,55,55,55,55,55,55,55,55,55,55,55,55,55,55,55,55,55,55,55,55,55,55,55,55,55,55,55,55,182,55,55,55,55,55,55,55,55,55,55,55,55,55,55,55,55,55,55,55,55,55,55,55,55,55,55,55,55,55,55,55
55,55,55,55,55,55,55,55,55,55,55,55,55,55,55,55,55,55,55,55,55,55,55,55,55,55,55,55,55,55,55,55,55,55,55,55,55,55,55,55,55,55,55,137,55,55,55,55,55,55,55,55,55,55,55,55,55,55,55,55,55,55,55,55,135,55,55,55,55,55,55,55,55,55,55,55,55,55,55,55
55,55,55,55,55,55,55,55,55,55,55,55,55,136,55,55,55,180,55,55,55,55,55,55,55,55,55,55,55,182,136,55,55,55,55,55,55,55,55,55,55,55,136,55,55,55,55,55,55,55,55,55,55,55,55,55,55,55,55,55,55,55,55,55,55,55,55,135,55,55,55,55,55,55,55,55,55,55,55,55
55,55,55,55,55,55,55,55,55,55,181,55,55,55,55,180,55,55,55,55,55,55,55,55,55,136,55,55,55,55,55,55,55,55,55,55,55,55,55,55,55,55,55,55,55,182,182,55,55,55,55,55,55,55,137,55,55,55,55,182,55,55,55,55,55,55,55,55,55,55,55,55,55,55,55,55,55,55,55,55
55,135,55,55,180,55,55,55,55,55,180,55,55,55,55,55,55,55,55,55,55,55,55,55,0,1,1,1,1,2,55,55,55,55,55,55,55,55,55,55,55,55,55,55,55,55,55,55,55,55,55,55,55,55,55,55,55,55,55,55,55,55,55,55,55,55,55,55,55,55,55,55,55,55,55,55,55,55,55,55
55,55,55,55,55,55,55,55,55,55,55,55,55,55,55,55,55,55,55,55,55,136,55,0,61,46,46,46,46,47,55,0,1,1,1,1,2,55,55,55,55,55,55,55,55,55,55,55,55,55,55,55,55,55,55,55,55,55,55,55,55,55,55,55,55,55,55,55,55,135,55,55,55,55,55,55,55,55,55,55
55,55,55,55,55,55,55,55,55,55,55,55,55,55,55,55,55,55,55,55,55,55,55,61,46,46,46,46,46,60,1,61,46,184,140,46,60,2,55,137,55,55,55,55,55,55,55,55,55,55,55,55,55,55,55,55,55,55,55,55,55,55,55,55,55,55,55,55,135,55,55,55,55,55,55,181,55,55,55,55
55,55,55,181,55,55,55,55,55,55,55,55,55,55,55,55,55,55,180,0,1,1,1,46,46,46,46,46,46,46,46,46,46,138,46,139,46,47,55,55,55,55,55,55,55,55,55,55,55,55,55,55,55,55,55,55,55,55,55,55,55,55,55,55,136,55,55,55,55,55,55,55,55,55,55,55,55,55,55,55
181,55,55,55,55,55,55,55,55,55,55,55,55,55,55,55,136,55,55,45,46,46,46,46,46,46,46,15,91,91,16,46,46,46,46,183,183,60,2,55,55,135,55,55,0,1,1,2,55,55,55,182,55,55,136,55,55,55,55,55,55,180,55,55,55,55,55,55,55,55,55,55,55,55,55,55,55,55,55,55
55,55,55,55,55,55,55,55,55,55,55,55,55,55,55,55,55,55,55,45,46,46,46,46,46,15,16,60,1,1,61,46,46,46,46,46,139,46,60,2,55,55,55,55,55,46,46,47,55,55,55,55,55,55,55,55,55,55,55,55,55,55,55,55,55,55,55,55,55,55,55,55,55,55,55,55,55,55,55,55
55,55,55,55,55,55,55,55,55,55,55,55,55,55,55,55,55,55,55,45,46,46,46,46,46,60,61,46,46,46,46,46,46,46,46,46,184,46,46,47,55,55,55,55,55,16,46,60,2,55,182,55,55,55,55,55,180,55,55,55,55,55,55,55,55,55,55,55,55,55,55,55,55,55,55,55,55,505,505,505
55,55,55,55,55,55,55,55,55,55,55,55,55,55,55,0,1,1,61,46,46,46,46,46,46,46,46,46,46,46,46,46,46,46,46,46,15,16,46,47,55,55,55,181,55,90,16,185,47,55,55,55,136,55,55,55,55,55,55,55,55,55,55,55,55,55,181,55,55,55,55,55,55,55,55,55,505,505,505,505
55,55,55,55,55,55,55,55,55,55,55,55,55,55,0,61,46,46,46,46,46,46,46,46,46,46,46,46,46,46,46,46,46,46,46,46,60,61,139,47,55,55,55,55,1,1,61,185,60,2,55,55,55,55,55,55,55,55,55,55,55,55,55,55,55,55,55,55,55,55,55,55,55,55,55,55,505,505,505,505
55,55,55,55,55,55,55,55,55,55,55,55,55,0,61,46,46,46,46,46,46,46,46,46,46,46,46,46,46,46,46,46,46,46,46,46,46,46,138,47,55,137,55,55,46,46,46,46,46,47,55,55,182,181,55,55,55,55,55,55,55,55,55,55,55,55,55,55,55,181,55,55,55,55,55,55,505,505,505,505
55,136,55,55,55,55,55,55,55,55,55,55,0,61,46,46,46,46,46,46,46,46,46,46,46,46,46,46,46,46,46,46,46,46,46,46,46,46,46,47,55,55,55,55,46,46,46,183,139,60,2,55,55,55,55,55,55,55,55,55,55,135,55,55,55,55,55,55,55,55,55,55,55,55,55,55,505,505,505,505
55,55,55,55,55,55,55,55,55,55,55,55,45,46,46,46,46,46,46,46,46,46,46,46,46,46,46,46,46,46,46,46,46,15,91,16,184,46,46,47,55,55,55,45,46,46,46,46,46,46,47,55,55,55,55,55,55,55,55,55,55,55,55,55,55,55,55,55,55,55,55,55,55,55,55,505,505,505,505,505
55,55,55,55,55,55,55,55,55,55,55,55,45,46,15,16,46,46,46,46,46,46,46,46,46,46,46,46,46,46,46,46,46,60,1,61,46,46,15,92,55,55,55,61,46,46,46,15,16,46,60,2,55,55,55,55,55,55,55,55,55,55,55,55,55,55,55,136,55,55,55,55,55,55,55,505,505,505,505,505
55,55,55,55,0,1,55,55,55,55,55,0,61,46,60,61,46,46,46,46,46,46,46,46,46,46,46,46,46,46,46,46,46,46,46,138,46,15,92,55,180,55,55,46,46,46,46,60,61,46,46,47,55,55,55,55,55,55,55,55,55,55,55,55,55,55,55,55,55,55,55,55,55,55,55,505,505,505,505,505
55,55,55,55,45,55,55,55,55,181,55,45,46,46,46,46,46,46,46,46,46,46,46,46,46,46,46,46,46,46,46,183,46,46,46,15,91,92,55,55,55,55,46,46,46,46,185,46,46,46,46,47,55,55,136,55,55,55,55,55,55,55,55,55,55,55,55,55,55,55,55,55,55,55,55,505,505,505,505,505
55,55,55,0,55,55,55,180,55,55,55,45,46,46,46,46,46,46,46,46,46,46,46,46,46,46,46,46,46,46,46,46,15,91,91,92,181,55,180,55,55,46,46,46,46,46,184,138,46,46,46,47,55,55,55,182,55,55,55,55,55,55,55,55,55,55,55,55,55,135,55,55,55,55,55,505,505,505,505,505
55,55,55,45,55,55,180,55,55,55,0,61,46,46,46,46,46,46,46,46,46,46,46,46,46,46,46,15,16,183,140,46,47,55,55,55,55,55,55,55,46,46,46,46,46,46,46,184,140,46,15,92,55,55,55,55,55,55,55,55,55,135,55,55,55,55,55,55,55,55,55,55,55,55,55,505,505,505,505,505
55,0,1,55,55,181,55,55,55,55,45,46,46,46,46,46,46,46,46,46,46,46,46,46,46,46,138,47,45,185,46,15,92,55,135,55,55,55,55,46,46,46,46,46,46,46,46,140,184,15,92,55,55,55,55,55,55,55,55,55,55,55,55,55,55,55,55,55,55,55,55,55,55,55,55,55,505,505,505,505
0,61,46,55,55,55,55,55,55,55,45,46,46,46,46,46,46,46,46,46,46,46,46,46,46,139,46,60,61,46,15,92,55,55,55,55,46,46,46,46,46,46,46,46,46,46,183,185,46,47,55,55,55,55,55,55,55,55,55,55,55,55,55,55,55,55,55,55,55,55,55,55,55,55,55,55,505,505,505,505
61,46,46,55,55,55,55,55,0,1,61,46,46,46,46,46,46,46,46,46,46,46,46,46,46,185,46,139,15,91,92,135,55,55,45,46,46,46,46,46,46,46,46,46,46,138,184,46,15,92,55,55,55,55,55,55,55,55,55,135,55,55,55,55,55,55,55,55,55,55,55,55,55,55,55,55,505,505,505,505
46,46,55,55,55,55,55,0,61,46,46,46,46,46,46,46,46,46,46,46,46,46,46,46,15,91,91,91,92,55,55,55,55,0,61,46,46,46,46,46,46,46,183,46,138,46,46,46,47,55,55,55,55,55,55,55,55,55,55,55,55,55,55,55,55,55,55,55,55,55,55,55,55,55,55,55,505,505,505,505
46,55,55,55,55,0,1,61,46,46,46,46,46,46,46,46,46,46,46,46,15,91,91,91,92,55,55,55,55,55,55,55,55,45,46,46,46,46,46,46,46,46,46,139,46,46,46,46,47,55,55,55,55,55,55,55,55,55,55,55,55,55,55,55,55,55,55,182,55,55,55,182,182,55,55,55,55,505,505,505
55,55,55,55,0,61,46,46,46,46,46,46,46,46,46,46,15,91,91,91,92,137,55,55,55,135,55,55,55,55,55,55,55,45,46,46,46,46,46,46,46,46,46,183,46,46,46,46,47,55,55,55,55,55,55,55,55,55,55,55,55,55,55,55,55,55,55,55,55,55,55,55,55,55,55,55,55,505,505,505
55,55,55,0,61,46,46,46,46,46,46,46,15,91,91,91,92,55,55,55,55,55,182,55,55,55,55,55,55,55,55,55,55,45,46,46,46,46,46,46,46,46,15,91,91,16,46,15,92,55,55,55,55,55,55,55,55,181,182,55,55,55,55,55,55,55,55,55,55,55,55,55,55,55,55,55,55,505,505,505
55,55,0,61,46,46,46,46,46,46,46,15,92,55,55,55,55,55,137,55,55,55,55,55,55,55,55,55,55,55,55,55,55,45,46,46,46,46,184,46,46,46,60,1,1,61,15,92,55,55,55,55,55,55,55,55,55,180,55,55,55,55,135,55,55,55,55,55,136,182,55,55,55,55,55,55,55,505,505,505
55,0,61,46,46,46,46,46,46,46,15,92,55,55,182,55,55,55,55,55,55,55,55,55,55,55,55,55,55,55,55,0,1,61,46,46,46,15,91,16,46,46,46,46,15,91,92,55,55,55,55,55,55,55,55,55,55,55,55,55,55,55,135,55,55,55,55,55,55,55,55,55,55,137,55,55,55,505,505,505
1,61,46,46,46,46,46,46,15,91,92,55,21,55,55,55,55,55,55,55,55,55,55,55,55,55,55,55,55,55,0,61,46,46,46,15,91,92,0,61,46,15,91,91,92,55,55,55,55,55,55,55,55,55,55,55,55,55,180,55,55,55,137,55,55,55,55,55,55,55,55,55,55,55,55,55,55,505,505,505
46,46,46,46,139,46,15,91,92,55,10,21,55,55,55,55,55,55,55,55,55,55,55,55,55,55,55,55,0,1,61,46,46,15,91,92,0,1,61,46,15,92,55,55,55,55,55,55,55,55,55,55,55,55,55,55,55,55,55,180,55,55,55,55,55,55,55,55,55,55,55,55,55,55,55,55,55,505,505,505
46,46,46,15,91,91,92,55,55,21,55,55,55,55,55,55,55,55,55,55,55,55,55,55,55,55,0,1,61,46,183,46,46,60,1,1,61,46,46,15,92,55,55,55,55,55,55,55,55,55,55,55,181,55,55,55,55,181,55,55,55,55,55,55,55,55,55,182,55,55,55,55,55,181,55,55,55,505,505,505
46,46,15,92,55,55,55,55,55,55,55,55,55,55,55,55,55,55,55,55,55,55,55,55,0,1,61,46,46,15,91,16,46,46,46,46,46,15,91,92,55,55,55,55,55,55,55,55,55,55,55,55,55,55,55,55,55,55,55,55,55,55,55,55,55,55,55,180,55,181,55,55,55,135,55,55,505,505,505,505
46,15,92,55,55,55,55,55,55,55,55,55,55,55,55,55,55,55,55,55,55,55,55,55,45,46,46,46,46,60,1,61,46,15,91,91,91,92,55,55,55,55,55,55,55,55,55,55,55,55,180,55,55,55,55,55,55,55,55,55,55,55,55,55,55,55,55,136,55,55,55,55,55,55,55,55,505,505,505,505
15,92,55,55,55,55,55,55,55,55,55,55,55,55,55,55,55,55,55,55,55,0,1,1,61,46,46,46,46,46,46,46,15,92,55,55,55,55,55,55,55,55,55,55,55,55,55,55,55,55,55,182,55,55,55,55,55,55,55,55,55,55,55,55,55,55,55,55,55,55,55,180,55,55,55,55,505,505,505,505
92,55,55,55,55,55,55,55,55,55,55,55,55,55,0,1,1,1,1,1,1,61,46,46,46,46,46,46,15,91,91,91,92,55,55,55,55,55,55,55,55,55,55,55,55,55,55,55,55,55,55,55,55,55,55,55,55,55,55,55,55,55,55,55,55,55,55,55,55,55,55,136,55,55,55,55,505,505,505,505
55,55,55,55,55,55,55,55,55,55,55,55,0,1,61,46,46,185,139,46,46,46,46,15,91,91,91,91,92,55,55,55,55,55,55,55,55,55,55,55,55,55,55,55,55,55,55,55,55,55,55,55,55,55,55,55,55,55,55,55,55,55,55,55,55,55,55,55,55,181,55,55,55,55,55,55,505,505,505,505
181,55,55,55,55,55,55,55,55,55,0,1,61,46,46,46,15,91,91,91,91,91,91,92,55,55,55,55,55,55,55,55,55,55,55,55,55,55,55,55,55,55,55,55,55,55,55,55,55,55,135,55,55,55,55,55,55,55,55,55,55,55,55,55,55,55,55,55,55,55,55,55,55,55,55,505,505,505,505,505
55,55,55,55,55,55,55,0,1,1,61,46,46,185,15,91,92,55,55,55,55,55,55,55,55,55,55,55,55,55,55,55,136,55,181,55,55,55,55,55,55,55,55,182,55,55,55,55,55,55,136,55,55,55,55,55,55,55,55,55,55,55,55,55,55,55,55,135,55,55,55,55,55,55,55,505,505,505,505,505
55,55,55,55,55,55,0,61,46,183,46,46,15,91,92,55,55,55,55,55,55,55,55,55,55,55,55,55,55,55,55,55,55,55,55,55,55,55,55,55,55,55,55,55,55,55,55,55,55,55,55,55,55,55,55,55,55,55,55,55,55,55,55,55,55,55,55,55,55,55,55,55,55,55,55,505,505,505,505,505
55,55,55,55,55,55,45,46,46,15,91,91,92,55,55,55,55,55,55,55,55,55,55,55,55,55,55,55,55,55,55,55,55,55,55,55,55,55,55,55,55,55,55,55,55,55,55,55,55,55,55,55,55,55,55,55,137,55,55,55,55,55,55,55,55,55,55,55,55,55,55,55,55,55,505,505,505,505,505,505
55,55,55,55,55,0,61,46,15,92,55,55,55,55,55,55,55,55,55,55,55,55,55,55,55,55,55,55,55,55,55,55,181,55,55,55,55,55,55,55,55,55,55,55,55,55,55,55,55,55,55,55,55,55,55,55,55,55,55,55,55,55,55,55,55,55,55,55,55,55,55,55,55,55,505,505,505,505,505,505
55,55,55,55,0,61,46,46,47,55,55,55,55,55,55,55,55,55,55,55,55,55,55,55,55,55,55,55,55,55,55,55,55,55,55,55,55,55,55,55,55,55,55,55,55,55,55,55,55,55,55,55,55,55,55,55,55,55,55,55,55,55,55,55,55,55,55,55,55,55,55,55,55,505,505,505,505,505,505,505
55,55,55,0,61,184,46,15,92,55,55,55,55,55,55,55,55,55,55,55,55,55,55,180,55,55,55,55,55,55,55,55,55,55,55,55,55,55,505,505,505,505,505,505,55,55,55,55,55,55,55,55,55,55,55,55,55,55,55,55,55,55,55,55,55,55,55,55,55,55,55,55,505,505,505,505,505,505,450,451
55,55,55,45,46,46,15,92,55,55,55,55,55,55,55,55,55,55,55,55,182,55,55,55,55,55,55,55,55,55,55,55,55,55,55,55,505,505,450,451,452,505,505,505,505,55,55,55,55,55,55,55,55,55,55,55,55,55,55,55,55,55,55,55,55,55,55,55,55,55,55,55,505,505,505,450,451,451,511,496
55,55,0,61,46,15,92,55,55,55,55,55,55,55,55,55,55,55,55,55,55,55,55,55,55,55,55,55,55,55,55,55,55,55,55,505,505,450,511,590,510,452,505,505,505,505,505,505,55,55,55,55,55,55,55,55,55,55,55,55,55,55,55,55,55,55,55,55,55,55,55,505,505,505,505,495,496,496,496,465
55,0,61,140,46,47,55,55,55,55,55,55,55,55,55,55,55,136,55,55,55,55,55,55,55,55,55,55,55,505,505,505,505,505,505,505,450,511,496,496,496,510,451,451,452,505,505,505,505,55,55,55,55,55,55,55,55,55,55,55,55,55,55,55,55,55,55,55,55,55,505,505,505,450,451,511,496,496,496,510
1,61,140,138,15,92,55,55,55,55,55,55,55,55,55,55,55,55,55,55,55,55,55,55,55,505,505,505,505,505,505,450,451,451,451,451,511,496,496,496,635,496,496,496,510,451,452,505,505,55,55,55,55,55,55,55,55,55,55,55,55,55,55,55,55,55,55,55,55,505,505,505,450,511,496,496,496,496,496,496
183,184,46,15,92,55,55,55,55,55,55,55,55,55,55,55,55,55,55,55,55,55,55,55,505,505,505,450,451,451,451,511,496,496,496,496,496,496,465,466,496,496,496,496,496,496,510,452,505,505,55,55,55,55,55,55,55,55,55,55,55,55,55,55,55,55,67,100,505,505,505,450,511,496,496,496,496,496,496,496
15,91,91,92,55,55,55,55,55,55,55,55,55,55,55,55,55,55,55,55,55,55,505,505,505,450,451,511,496,633,496,496,496,496,496,633,496,496,510,511,496,496,496,496,496,496,496,497,505,505,55,55,55,55,55,55,55,55,55,55,55,55,55,55,505,505,505,450,451,451,451,511,496,496,496,496,496,496,496,496
92,55,55,55,55,55,55,55,55,55,55,55,55,55,55,55,55,55,55,55,55,505,450,451,451,511,496,496,496,496,496,496,496,496,496,496,635,496,496,496,496,496,496,496,496,496,496,510,451,452,505,505,505,505,505,505,505,505,505,505,505,505,505,505,505,450,451,511,496,496,496,496,496,496,496,496,496,496,496,496
55,55,55,55,55,55,55,55,55,55,55,55,55,55,55,55,55,55,55,505,505,505,495,496,496,496,496,496,496,496,496,635,588,496,496,496,496,496,496,496,496,496,496,496,496,496,496,496,496,497,505,505,505,505,505,505,505,505,505,505,505,505,505,505,505,495,496,496,496,496,496,496,496,496,496,496,496,496,496,635
55,55,55,55,55,55,55,55,55,55,55,55,55,55,55,55,55,505,505,450,451,451,511,589,496,496,496,496,496,496,496,496,496,496,496,496,496,496,496,496,496,496,496,496,496,496,496,465,541,542,505,505,505,505,505,505,505,505,505,505,505,505,505,505,505,495,496,496,496,496,496,496,496,496,496,496,496,496,496,634
55,55,55,55,55,55,55,55,55,55,55,55,55,55,55,55,505,450,451,511,496,496,496,635,496,496,589,496,496,496,496,496,496,496,496,496,496,496,496,496,496,496,496,496,496,496,496,510,452,505,505,505,505,505,505,505,505,505,505,505,505,505,586,505,450,511,496,496,496,496,496,496,496,496,496,496,496,496,496,496
55,55,55,55,55,55,55,55,55,55,55,55,55,55,55,505,450,511,496,496,496,496,496,496,496,496,496,496,496,496,496,496,496,496,496,496,496,496,496,496,588,496,496,635,496,635,496,496,497,505,505,505,505,505,505,505,505,505,505,505,505,505,505,505,495,496,496,496,496,496,496,496,496,496,496,496,496,496,496,496
55,55,55,55,55,55,55,55,55,55,55,55,55,55,505,450,511,496,496,496,496,496,496,496,496,496,496,496,496,496,496,496,496,496,496,496,496,496,496,496,634,496,496,496,635,588,496,496,497,505,505,505,505,505,505,505,505,505,505,505,505,505,505,505,495,496,496,496,496,496,496,496,496,496,496,496,496,496,496,496
55,55,55,55,55,55,55,55,55,55,55,55,55,505,505,495,496,496,496,496,496,496,496,496,496,496,496,496,496,496,496,496,496,496,496,496,496,496,496,496,496,496,496,496,496,496,496,496,497,505,505,586,505,505,505,505,505,505,505,505,505,631,505,505,495,496,496,496,496,496,496,496,496,496,496,465,541,541,541,466
55,55,55,55,55,55,55,55,55,55,55,55,505,505,450,511,496,496,496,496,496,496,496,496,496,496,496,496,496,496,496,496,496,496,496,496,496,496,590,496,496,496,496,496,496,496,496,496,497,505,505,505,632,505,505,587,505,585,505,505,505,505,505,505,495,496,496,496,496,496,496,496,496,465,541,542,505,505,505,540
55,55,55,55,55,55,55,55,55,55,55,55,505,505,495,496,496,496,496,496,496,496,496,496,496,496,496,496,496,496,496,496,496,496,496,496,496,588,496,496,496,496,496,496,465,466,496,496,497,505,505,630,505,505,505,505,505,505,505,505,632,505,505,450,511,496,496,496,496,496,496,465,541,542,505,505,505,505,505,505
