496,496,496,496,496,496,496,465,542,505,505,505,505,505,505,505,505,505,505,505,505,505,505,505,505,505,505,505,505,505,505,450,511,496,496,496,496,497,495,496,496,496,496,496,496,465,466,496,496,496,496,497,505,505,505,505,631,505,585,505,631,632,632,505,505,505,505,505,505,586,585,505,505,505,505,505,505,505,505,505
496,496,496,496,496,496,465,542,505,505,505,505,505,505,505,505,505,505,505,505,505,505,505,505,505,505,505,505,450,451,451,511,496,496,496,496,465,542,495,496,496,496,496,496,496,510,511,496,496,496,496,497,505,505,505,505,505,505,505,505,505,505,632,505,505,505,505,505,505,505,505,505,505,505,505,505,505,505,505,505
496,496,496,496,496,465,542,505,505,505,505,505,505,505,505,505,505,505,505,505,505,505,505,505,505,505,450,451,511,496,496,496,496,496,496,465,542,450,511,496,496,496,496,496,496,496,496,496,496,496,465,542,505,505,505,505,505,505,505,585,505,505,505,505,585,505,632,505,505,505,505,505,505,505,505,505,505,505,505,505
496,496,496,496,496,497,505,505,505,505,505,505,505,505,505,505,505,505,505,505,505,505,505,505,505,505,495,496,496,589,496,496,465,541,541,505,505,495,496,496,496,496,496,496,496,496,496,496,496,465,542,505,505,505,505,505,505,505,505,505,505,505,505,505,505,505,505,632,505,505,505,505,505,631,505,505,505,505,505,632
496,496,496,496,496,497,505,505,505,505,505,505,505,505,505,505,505,505,505,505,505,505,505,505,450,451,511,633,496,496,465,542,505,505,505,505,450,511,496,496,496,496,496,496,496,496,496,496,465,542,505,505,505,585,505,505,505,505,505,505,505,505,505,505,505,505,505,505,505,505,505,505,505,505,505,505,505,505,505,505
496,496,496,496,496,497,505,505,505,505,505,505,505,505,505,505,505,505,505,505,505,450,451,451,511,496,634,496,496,496,510,451,451,452,505,450,511,496,496,496,496,496,496,496,496,465,541,541,542,505,505,505,505,505,505,505,505,505,632,505,505,505,505,505,505,505,505,505,505,505,505,505,505,505,505,505,505,586,586,505
496,496,496,465,541,542,505,505,505,505,505,505,505,505,505,505,505,505,505,505,450,511,496,496,496,496,496,496,496,496,496,496,496,510,451,511,496,496,496,496,496,496,496,496,465,542,505,505,505,505,505,505,505,505,505,505,505,505,505,505,505,505,505,505,505,632,505,505,505,505,505,585,585,505,505,505,505,505,505,505
496,496,496,497,505,505,505,505,505,505,505,505,505,505,505,505,505,450,451,451,511,496,496,496,496,496,496,496,496,496,496,496,496,496,496,496,496,496,496,588,496,496,496,496,497,505,505,505,505,505,505,505,505,505,505,505,630,505,505,505,505,505,505,505,505,505,505,505,505,505,505,505,505,505,505,505,505,505,505,505
496,496,496,510,452,505,505,505,505,505,505,505,505,505,505,450,451,511,496,496,496,496,496,496,496,496,496,496,496,496,496,496,496,496,496,496,496,496,496,590,496,496,496,496,497,505,505,631,505,505,631,630,505,505,505,505,505,505,505,505,505,505,505,632,505,505,505,505,505,505,505,505,505,505,505,505,505,505,505,505
496,496,496,496,497,505,505,505,505,505,505,505,505,505,450,511,496,496,496,496,496,496,496,496,496,496,496,496,496,496,496,496,496,496,496,496,496,496,496,588,496,496,496,496,497,505,505,505,505,505,505,505,505,505,505,505,505,505,505,505,505,505,505,505,505,505,505,505,505,505,505,587,505,505,505,632,505,505,505,505
496,465,541,541,542,505,505,505,505,505,505,505,505,505,495,496,496,496,496,496,496,496,496,496,496,496,496,496,496,496,496,496,496,496,496,496,496,496,496,496,496,496,496,496,497,505,505,505,505,505,505,505,505,505,505,632,505,505,505,505,505,505,505,505,505,505,505,505,505,505,505,505,505,505,505,505,505,505,505,505
541,542,505,505,505,505,505,505,505,505,505,505,505,505,495,496,496,496,496,496,496,496,496,496,496,496,496,496,496,496,496,496,496,496,496,496,496,496,496,496,496,589,496,496,497,505,505,505,505,505,505,505,505,505,630,630,631,505,505,505,505,505,505,505,505,505,505,505,505,505,505,505,505,505,505,505,505,505,505,505
505,505,505,505,505,505,505,505,505,505,505,505,505,505,495,496,465,466,496,496,496,496,496,496,496,496,496,496,496,496,496,496,496,496,496,496,496,589,496,496,496,496,496,465,542,505,505,505,505,586,505,505,505,505,505,505,505,505,505,505,505,505,505,505,505,505,505,631,505,505,505,505,505,505,505,505,505,505,505,505
505,505,505,505,505,505,505,505,505,505,505,505,505,505,540,541,542,495,496,496,496,496,496,496,496,496,496,496,496,496,496,496,496,496,496,496,496,496,496,496,496,496,465,542,505,505,505,631,505,505,505,505,505,632,505,505,587,505,505,505,631,505,505,505,505,505,505,505,505,505,505,505,630,505,505,505,505,505,505,505
505,505,505,505,505,505,505,505,505,505,505,505,505,505,505,505,505,540,541,466,496,496,496,496,496,496,496,496,496,496,496,496,496,496,496,496,496,496,496,496,496,496,497,505,505,505,505,505,505,505,505,505,505,630,505,505,505,505,505,505,631,505,505,505,505,505,505,505,585,505,505,505,505,505,505,505,505,505,505,505
505,505,505,505,505,505,505,505,505,505,505,505,505,505,505,505,505,505,505,540,541,466,496,496,496,496,496,496,496,496,496,496,496,496,496,496,496,496,496,588,496,496,497,505,505,505,586,505,505,505,505,505,505,505,505,505,505,505,505,505,505,505,505,505,505,505,505,505,505,505,505,505,505,505,505,505,505,505,505,505
505,505,505,505,505,505,505,505,505,505,505,505,505,505,505,505,505,505,631,505,505,495,496,496,496,496,496,496,496,496,496,496,496,496,496,496,496,496,496,496,496,465,542,505,505,587,630,632,505,505,505,505,505,505,505,505,505,505,505,505,505,505,587,505,505,505,505,505,505,505,505,505,505,505,505,505,505,505,505,505
505,505,505,505,505,505,505,505,505,505,505,505,505,505,505,505,505,505,632,587,505,495,496,496,496,496,496,496,496,496,496,496,496,496,496,496,496,496,496,496,496,497,505,505,505,505,505,505,505,505,505,505,505,505,505,505,505,505,505,505,505,505,587,586,505,586,505,505,505,505,505,505,505,505,505,505,505,505,505,632
505,505,505,505,505,505,505,505,505,505,505,505,505,505,505,505,505,505,586,631,505,540,541,466,496,496,496,496,496,496,496,496,496,496,496,496,496,496,496,496,496,497,505,505,587,505,505,505,505,505,505,505,505,587,505,505,505,586,505,505,505,505,505,505,505,505,505,505,505,505,505,505,505,505,505,505,505,505,505,505
505,505,505,505,505,505,505,505,505,505,505,505,505,505,505,505,505,505,505,505,505,505,505,540,541,541,466,496,496,496,496,496,496,496,496,496,496,496,496,496,496,497,505,505,505,505,505,505,505,505,505,505,505,505,505,505,505,505,505,505,505,505,505,505,505,505,505,505,505,505,505,505,505,505,505,505,505,505,505,505
505,505,505,505,505,505,505,505,505,505,505,505,505,505,505,505,505,505,505,505,505,505,505,505,505,505,540,466,496,496,496,496,496,496,496,496,496,496,633,496,496,497,505,505,505,505,585,505,631,505,505,505,505,585,505,505,505,505,505,505,505,632,505,505,505,505,505,505,505,505,505,505,505,587,587,505,505,505,505,505
505,505,505,505,505,505,505,505,505,505,505,505,505,505,505,505,505,505,505,505,505,505,505,505,505,505,630,540,466,496,496,496,496,496,496,496,496,496,496,496,496,510,452,505,505,505,505,505,505,505,505,505,505,630,505,505,505,505,505,505,505,505,505,505,505,505,505,505,505,505,505,505,505,505,505,505,505,505,505,450
505,505,505,505,505,505,505,505,505,505,505,505,505,505,505,505,505,505,505,505,505,505,505,505,505,505,505,505,540,466,496,496,496,496,496,496,496,496,496,496,633,496,497,505,505,505,505,505,505,505,505,505,505,505,505,505,505,505,505,505,505,505,630,505,505,505,505,505,505,505,505,505,505,505,505,505,505,450,451,511
505,505,505,505,505,505,505,505,505,505,505,505,505,505,505,505,505,505,505,505,505,505,505,505,505,631,505,505,505,540,466,496,496,496,496,496,496,496,496,496,496,496,497,505,505,505,505,505,505,505,505,505,505,505,505,505,505,505,505,505,505,505,505,505,505,505,505,505,632,505,505,505,505,505,505,450,451,511,496,496
505,505,505,505,505,505,505,505,505,505,505,505,505,505,505,505,505,505,505,505,505,505,505,505,505,505,505,505,505,505,495,496,496,496,496,496,496,496,496,496,496,496,510,452,505,505,505,505,505,505,631,505,505,505,505,505,505,505,505,505,505,505,505,505,505,586,630,505,505,505,505,505,505,505,505,495,496,496,496,496
505,505,505,505,505,505,505,505,505,505,505,505,505,505,505,505,505,505,505,505,505,505,505,505,505,505,505,505,586,505,540,541,466,496,496,496,496,496,496,496,588,635,496,497,505,505,505,505,505,505,505,505,505,505,505,505,505,505,505,505,630,505,505,505,505,505,505,505,505,505,505,505,505,505,505,495,496,496,496,496
505,505,505,505,505,505,505,505,505,505,505,505,505,505,505,505,505,505,505,505,505,505,505,505,505,505,505,505,586,505,505,505,495,496,496,496,496,496,496,496,496,496,496,497,505,505,505,505,505,505,505,505,505,505,505,505,505,505,505,505,505,505,505,505,505,505,585,505,505,505,505,505,505,505,450,511,496,496,496,496
280,280,280,280,280,280,280,280,280,280,280,280,280,280,505,505,505,505,505,505,505,505,505,505,505,505,505,505,505,505,632,632,540,466,496,496,496,496,496,496,496,496,496,497,505,505,505,632,505,505,505,505,505,505,505,505,505,505,505,505,505,505,505,631,505,505,505,505,505,505,505,505,505,450,511,496,496,496,496,496
280,280,280,280,280,280,280,280,280,280,280,280,280,280,505,505,505,505,505,505,505,505,505,505,505,505,505,505,505,505,505,505,505,495,496,496,496,496,496,496,496,496,496,497,505,505,505,505,505,505,505,505,505,505,505,505,505,505,505,505,505,505,505,505,505,505,505,505,505,505,505,505,450,511,496,496,496,496,496,465
280,280,280,280,280,280,280,280,280,280,280,280,280,280,505,505,505,505,505,505,505,505,505,505,505,505,505,505,505,505,505,505,505,540,466,496,496,496,496,635,496,496,635,497,505,505,505,505,505,505,505,505,505,505,505,505,505,505,505,505,505,587,505,505,505,505,505,505,505,505,450,451,511,496,496,496,496,496,465,542
280,280,280,280,280,280,280,280,280,280,280,280,280,280,505,505,505,505,505,505,505,505,505,505,505,505,505,505,505,505,505,505,585,505,495,496,496,496,496,590,496,590,496,497,505,505,505,505,505,505,505,505,505,505,505,505,505,505,505,505,505,585,505,505,505,505,505,505,450,451,511,496,496,496,496,496,496,465,542,505
280,280,280,280,280,280,280,280,280,280,280,280,280,280,505,505,505,505,505,505,505,505,505,505,505,505,505,505,505,505,505,505,505,505,540,541,541,466,496,496,588,496,496,497,505,505,505,630,505,505,505,505,505,505,505,505,505,505,505,505,630,505,505,505,505,505,450,451,511,496,496,496,496,496,496,496,465,542,505,505
280,280,280,280,280,280,280,280,280,280,280,280,280,280,505,505,505,505,505,505,505,505,505,505,505,505,505,505,505,505,505,505,505,505,587,505,505,540,466,496,496,496,496,497,505,505,505,505,505,630,630,505,505,505,505,505,505,505,505,505,632,505,505,505,505,450,511,496,496,496,496,496,496,496,496,496,497,505,505,505
280,280,280,280,280,280,280,280,280,280,280,280,280,280,505,505,505,505,505,505,505,505,505,505,505,505,505,505,505,505,505,505,505,505,505,505,632,505,540,541,541,466,496,497,505,505,505,505,505,505,505,505,505,505,505,586,505,505,505,505,505,505,505,505,505,495,496,496,496,496,496,496,496,496,496,496,497,505,505,505
280,280,280,280,280,280,280,280,280,280,280,280,280,280,505,505,505,505,505,505,505,505,505,505,505,505,505,505,505,505,505,505,505,505,505,505,505,505,505,505,505,540,541,542,505,505,505,505,505,505,505,585,505,505,505,505,505,505,505,505,505,505,505,505,450,511,465,466,496,496,496,496,496,496,496,465,542,505,505,505
280,280,280,280,280,280,280,280,280,280,280,280,280,280,280,280,280,280,280,280,280,280,280,280,280,505,505,505,505,505,505,505,505,505,505,505,505,505,505,505,505,505,505,505,505,505,505,505,505,505,505,505,505,505,505,505,505,505,505,505,505,505,505,505,495,496,497,495,496,496,496,496,496,465,541,542,505,505,586,505
280,280,280,280,280,280,280,280,280,280,280,280,280,280,280,280,280,280,280,280,280,280,280,280,280,505,505,505,505,505,505,505,505,505,505,505,505,505,505,630,505,587,505,505,505,505,505,505,505,505,505,505,505,505,505,505,505,505,505,505,505,450,451,452,495,496,510,511,496,496,635,496,465,542,505,505,505,505,505,450
280,280,280,280,280,280,280,280,280,280,280,280,280,280,280,280,280,280,280,280,280,280,280,280,280,505,505,505,505,505,505,505,505,505,505,505,505,505,505,505,505,505,585,585,585,505,505,505,505,505,505,505,505,505,505,505,632,505,505,505,505,495,496,510,511,496,496,496,496,496,634,465,542,505,505,505,630,450,451,511
280,280,280,280,280,280,280,280,280,280,280,280,280,280,280,280,280,280,280,280,280,280,280,280,280,505,505,505,505,505,505,505,505,505,505,505,505,505,505,505,505,505,505,505,505,631,505,505,505,505,505,505,505,505,505,505,505,505,505,505,450,511,496,496,496,496,496,496,635,634,496,497,505,505,505,587,505,495,496,496
280,280,280,280,280,280,280,280,280,280,280,280,280,280,280,280,280,280,280,280,280,280,280,280,280,505,505,505,505,505,505,505,505,505,505,505,505,505,505,505,505,505,505,505,505,505,505,505,505,505,505,632,505,505,505,505,505,505,505,505,495,496,496,496,496,496,496,496,633,496,496,497,505,505,505,586,505,495,496,496
280,280,280,280,280,280,280,280,280,280,280,280,280,280,280,280,280,280,280,280,280,280,280,280,280,505,505,505,505,505,505,505,505,505,505,505,505,505,505,505,505,505,505,505,505,505,505,505,505,505,505,505,631,505,505,505,505,505,505,505,495,496,496,496,496,496,496,496,589,589,496,497,505,505,505,505,450,511,496,634
280,280,280,280,280,280,280,280,280,280,280,280,280,280,280,280,280,280,280,280,280,280,280,280,280,505,505,505,505,505,505,505,505,505,505,505,505,505,505,505,505,505,505,505,632,505,505,505,505,630,505,505,505,505,505,505,505,505,505,505,540,466,496,496,496,496,496,496,496,496,496,497,505,631,505,505,495,496,496,634
280,280,280,280,280,280,280,280,280,280,280,280,280,280,280,280,280,280,280,280,280,280,280,280,280,505,505,505,505,505,505,505,505,505,505,505,505,505,505,505,505,505,505,505,505,505,505,505,505,505,505,505,505,505,505,505,505,505,505,505,505,495,496,496,496,496,496,496,496,496,496,497,505,631,587,505,495,496,496,588
280,280,280,280,280,280,280,280,280,280,280,280,280,280,280,280,280,280,280,280,280,280,280,280,280,505,505,505,505,505,505,505,505,505,505,505,505,505,505,505,505,505,505,505,505,505,630,505,505,505,505,505,505,505,631,630,505,505,505,505,505,495,633,496,496,496,496,496,496,496,496,510,452,505,505,505,495,496,496,635
280,280,280,280,280,280,280,280,280,280,280,280,280,280,280,280,280,280,280,280,280,280,280,280,280,505,505,505,505,505,505,505,505,505,505,505,505,505,505,505,505,505,505,505,505,632,505,505,505,505,505,505,505,505,505,505,505,505,587,505,505,495,496,496,496,589,496,496,496,496,496,496,497,505,505,505,540,466,496,496
280,280,280,280,280,280,280,280,280,280,280,280,280,280,280,280,280,280,280,280,280,280,280,280,280,505,505,505,505,505,505,505,505,505,505,505,505,505,505,505,505,505,505,505,505,505,505,505,505,505,505,505,505,505,505,505,505,505,505,505,450,511,633,496,496,496,496,496,496,496,496,496,497,505,632,505,505,495,496,496
280,280,280,280,280,280,280,280,280,280,280,280,280,280,280,280,280,280,280,280,280,280,280,280,280,505,505,505,505,505,505,505,505,505,505,505,505,505,505,505,505,505,505,505,505,505,505,505,505,505,586,505,505,505,505,505,631,505,505,505,495,635,634,496,496,496,496,496,496,496,496,496,497,505,505,505,505,540,466,496
280,280,280,280,280,280,280,280,280,280,280,280,280,280,280,280,280,280,280,280,280,280,280,280,280,280,280,280,280,280,505,505,505,505,505,505,505,505,505,505,505,505,505,505,587,631,505,505,505,505,505,505,505,505,505,586,631,505,505,505,495,590,496,634,496,588,496,496,496,496,496,496,497,505,505,505,505,505,540,541
280,280,280,280,280,280,280,280,280,280,280,280,280,280,280,280,280,280,280,280,280,280,280,280,280,280,280,280,280,280,505,505,505,505,505,505,505,505,505,505,505,505,505,505,505,505,505,505,505,505,505,505,505,505,505,505,505,505,505,505,495,496,633,496,496,496,496,496,496,496,496,465,542,505,505,505,505,630,505,505
280,280,280,280,280,280,280,280,280,280,280,280,280,280,280,280,280,280,280,280,280,280,280,280,280,280,280,280,280,280,505,505,505,505,505,505,505,505,505,505,505,505,505,505,505,505,505,587,585,505,505,587,587,505,505,505,505,505,505,505,495,496,496,496,496,496,496,496,496,496,633,510,452,505,505,505,505,505,631,505
280,280,280,280,280,280,280,280,280,280,280,280,280,280,280,280,280,280,280,280,280,280,280,280,280,280,280,280,280,280,505,505,505,505,505,505,505,505,505,505,505,505,505,505,505,505,505,505,505,505,505,631,505,505,505,505,505,505,505,505,495,496,496,496,496,496,496,496,496,496,496,496,497,505,505,505,505,505,505,450
280,280,280,280,280,280,280,280,280,280,280,280,280,280,280,280,280,280,280,280,280,280,280,280,280,280,280,280,280,280,505,505,505,505,505,505,505,505,505,505,505,505,505,505,505,505,505,505,505,505,505,632,505,632,505,505,505,505,505,450,511,496,633,496,496,496,496,496,496,496,496,496,497,505,505,505,505,505,505,495
280,280,280,280,280,280,280,280,280,280,280,280,280,280,280,280,280,280,280,280,280,280,280,280,280,280,280,280,280,280,505,505,505,505,505,505,505,505,505,505,505,505,505,505,505,505,505,505,505,505,505,505,505,632,631,505,505,505,505,495,496,496,634,496,496,496,496,496,496,588,496,496,497,505,505,505,505,505,505,495
280,280,280,280,280,280,280,280,280,280,280,280,280,280,280,280,280,280,280,280,280,280,280,280,280,280,280,280,280,280,505,505,505,505,505,505,505,505,505,505,505,505,505,505,505,505,505,505,505,505,505,505,505,585,587,505,586,505,505,495,496,496,633,496,496,496,496,496,496,588,496,496,510,452,505,505,505,505,505,495
280,280,280,280,280,280,280,280,280,280,280,280,280,280,280,280,280,280,280,280,280,280,280,280,280,280,280,280,280,280,505,505,505,505,505,505,505,505,505,505,505,505,505,505,505,505,505,505,505,505,505,505,505,505,505,505,505,505,505,495,496,496,588,496,496,496,496,496,496,496,588,496,496,497,505,505,505,505,505,495
280,280,280,280,280,280,280,280,280,280,280,280,280,280,280,280,280,280,280,280,280,280,280,280,280,280,280,280,280,280,505,505,505,505,505,505,505,505,505,505,505,505,505,505,505,505,505,505,505,505,505,505,505,505,505,505,505,505,505,495,496,633,496,496,496,496,496,496,496,496,634,496,496,497,505,505,505,505,505,495
280,280,280,280,280,280,280,280,280,280,280,280,280,280,280,280,280,280,280,280,280,280,280,280,280,280,280,280,280,280,505,505,505,505,505,505,505,505,505,505,505,505,505,505,505,505,505,505,505,505,631,585,505,505,505,505,505,505,450,511,496,635,496,496,496,496,496,496,496,496,496,496,496,497,505,505,505,505,505,495
280,280,280,280,280,280,280,280,280,280,280,280,280,280,280,280,280,280,280,280,280,280,280,280,280,280,280,280,280,280,505,505,505,505,505,505,505,505,505,505,505,505,505,505,505,505,505,505,505,505,505,585,505,505,505,505,505,505,495,496,590,635,496,496,496,496,496,496,496,496,496,496,496,510,452,505,505,505,505,495
280,280,280,280,280,280,280,280,280,280,280,280,280,280,280,280,280,280,280,280,280,280,280,280,280,280,280,280,280,280,505,505,505,505,505,505,505,505,505,505,505,505,505,505,505,505,505,505,505,505,505,505,505,505,587,505,505,505,495,496,588,590,496,496,496,496,496,496,496,496,496,496,589,496,497,505,505,505,505,540
280,280,280,280,280,280,280,280,280,280,280,280,280,280,280,280,280,280,280,280,280,280,280,280,280,280,280,280,280,280,280,280,280,505,505,505,505,505,505,505,505,505,505,505,505,505,505,505,505,505,631,505,505,505,505,505,505,505,495,496,590,496,634,496,496,496,496,496,496,496,496,496,496,496,510,452,505,505,505,505
280,280,280,280,280,280,280,280,280,280,280,280,280,280,280,280,280,280,280,280,280,280,280,280,280,280,280,280,280,280,280,280,280,505,505,505,505,505,505,505,505,505,505,505,505,505,505,630,505,505,632,505,505,505,587,505,505,505,495,496,496,496,496,496,496,496,496,496,496,496,496,496,496,496,496,510,452,505,505,505
280,280,280,280,280,280,280,280,280,280,280,280,280,280,280,280,280,280,280,280,280,280,280,280,280,280,280,280,280,280,280,280,280,505,505,505,505,505,505,505,505,505,505,505,505,505,505,505,505,505,505,505,505,505,630,505,505,505,495,496,496,496,496,496,496,496,496,496,496,496,496,496,496,634,496,496,510,452,505,505
280,280,280,280,280,280,280,280,280,280,280,280,280,280,280,280,280,280,280,280,280,280,280,280,280,280,280,280,280,280,280,280,280,505,505,505,505,505,505,505,505,505,505,505,505,505,505,505,505,505,505,505,586,505,505,505,505,505,495,496,496,496,496,496,496,496,496,496,496,496,496,496,496,634,496,496,496,497,505,505
280,280,280,280,280,280,280,280,280,280,280,280,280,280,280,280,280,280,280,280,280,280,280,280,280,280,280,280,280,280,280,280,280,505,505,505,505,505,505,505,505,505,505,505,505,505,505,505,505,505,505,505,586,505,505,505,505,505,495,496,496,496,496,496,496,496,496,496,496,496,496,496,496,496,589,496,496,497,505,505
280,280,280,280,280,280,280,280,280,280,280,280,280,280,280,280,280,280,280,280,280,280,280,280,280,280,280,280,280,280,280,280,280,505,505,505,505,505,505,505,505,505,505,505,505,505,505,505,505,505,505,505,505,505,505,505,505,505,495,496,496,496,496,496,496,496,496,496,496,496,496,496,496,496,496,496,496,497,505,505
280,280,280,280,280,280,280,280,280,280,280,280,280,280,280,280,280,280,280,280,280,280,280,280,280,280,280,280,280,280,280,280,280,505,505,505,505,505,505,505,505,505,505,505,505,505,505,505,505,505,505,505,632,505,505,505,505,505,495,496,496,496,496,496,496,496,496,496,496,496,496,496,496,496,496,496,496,510,452,505
280,280,280,280,280,280,280,280,280,280,280,280,280,280,280,280,280,280,280,280,280,280,280,280,280,280,280,280,280,280,280,280,280,505,505,505,505,505,505,505,505,505,505,505,505,505,505,505,505,505,505,505,505,505,630,632,505,505,495,496,496,496,496,496,496,496,496,496,496,496,496,496,496,496,496,496,634,496,497,505
280,280,280,280,280,280,280,280,280,280,280,280,280,280,280,280,280,280,280,280,280,280,280,280,280,280,280,280,280,280,280,280,280,505,505,505,505,505,505,505,505,505,505,505,505,505,505,505,505,505,586,505,505,505,505,505,505,505,495,496,496,496,496,496,496,496,496,496,496,496,496,496,496,496,496,496,496,496,497,505
280,280,280,280,280,280,280,280,280,280,280,280,280,280,280,280,280,280,280,280,280,280,280,280,280,280,280,280,280,280,280,280,280,505,505,505,505,505,505,505,505,505,505,505,505,505,505,505,505,505,505,505,505,505,505,505,505,505,540,466,496,496,496,496,496,496,496,496,496,496,496,496,496,496,496,496,496,496,497,505
280,280,280,280,280,280,280,280,280,280,280,280,280,280,280,280,280,280,280,280,280,280,280,280,280,280,280,280,280,280,280,280,280,505,505,505,505,505,505,505,505,505,505,505,505,505,505,505,505,586,505,505,505,505,505,505,505,505,505,495,496,496,496,496,496,496,496,496,496,496,496,496,496,496,496,496,496,496,510,452
280,280,280,280,280,280,280,280,280,280,280,280,280,280,280,280,280,280,280,280,280,280,280,280,280,280,280,280,280,280,280,280,280,505,505,505,505,505,505,505,505,505,505,505,505,505,505,505,505,505,505,505,631,631,505,505,505,505,505,495,590,496,496,496,496,496,496,496,496,496,496,496,496,496,496,496,496,589,496,497
280,280,280,280,280,280,280,280,280,280,280,280,280,280,280,280,280,280,280,280,280,280,280,280,280,280,280,280,280,280,280,280,280,505,505,505,505,505,505,505,505,505,505,505,505,505,505,505,505,505,505,505,505,505,505,586,505,505,505,495,496,633,496,496,496,496,496,496,496,496,496,496,496,496,496,496,496,496,496,497
280,280,280,280,280,280,280,280,280,280,280,280,280,280,280,280,280,280,280,280,280,280,280,280,280,280,280,280,280,280,280,280,280,505,505,505,505,505,505,505,505,505,505,505,505,505,505,505,505,505,505,505,505,505,585,505,505,505,505,495,496,496,496,496,496,496,496,496,496,496,496,496,496,496,496,496,496,496,496,497
280,280,280,280,280,280,280,280,280,280,280,280,280,280,280,280,280,280,280,280,280,280,280,280,280,280,280,280,280,280,280,280,280,505,505,505,505,505,505,505,505,505,505,505,505,505,505,505,505,505,505,505,505,632,505,505,505,505,505,495,496,496,496,496,496,496,496,496,496,496,496,496,496,496,496,496,496,496,496,497
280,280,280,280,280,280,280,280,280,280,280,280,280,280,280,280,280,280,280,280,280,280,280,280,280,280,280,280,280,280,280,280,280,505,505,505,505,505,505,505,505,505,505,505,505,505,505,505,505,505,505,505,505,630,505,505,505,505,505,495,496,496,496,589,635,589,588,496,496,496,496,496,496,496,496,496,496,496,496,510
280,280,280,280,280,280,280,280,280,280,280,280,280,280,280,280,280,280,280,280,280,280,280,280,280,280,280,280,280,280,280,280,280,505,505,505,505,505,505,505,505,505,505,505,505,505,505,505,505,505,505,505,505,505,505,505,505,505,505,495,496,496,496,496,496,635,496,496,496,496,496,496,496,496,496,496,496,496,496,633
280,280,280,280,280,280,280,280,280,280,280,280,280,280,280,280,280,280,280,280,280,280,280,280,280,280,280,280,280,280,280,280,280,505,505,505,505,505,505,505,505,505,505,505,505,505,505,585,505,505,505,505,505,505,505,505,505,505,505,540,466,496,496,590,634,589,496,496,496,496,496,496,496,496,496,496,496,496,496,496
280,280,280,280,280,280,280,280,280,280,280,280,280,280,280,280,280,280,280,280,280,280,280,280,280,280,280,280,280,280,280,280,280,505,505,505,505,505,505,505,505,505,505,505,505,505,505,505,505,505,505,505,505,505,505,505,505,505,505,505,495,496,496,496,633,496,496,496,496,496,496,496,496,496,496,496,496,496,496,496
280,280,280,280,280,280,280,280,280,280,280,280,280,280,280,280,280,280,280,280,280,280,280,280,280,280,280,280,280,280,280,280,280,505,505,505,505,505,505,505,505,505,505,505,505,505,505,505,505,505,505,505,505,505,505,505,505,505,505,505,495,589,634,496,588,496,496,496,496,496,496,496,496,496,496,496,496,496,496,496
280,280,280,280,280,280,280,280,280,280,280,280,280,280,280,280,280,280,280,280,280,280,280,280,280,280,280,280,280,280,280,280,280,505,505,505,505,505,505,505,505,505,505,505,505,505,505,505,631,505,505,505,505,505,505,587,505,505,505,505,495,588,496,588,589,496,496,496,496,496,496,496,496,496,496,496,496,496,496,496
