280,280,280,280,280,280,280,280,280,280,280,280,280,280,280,280,280,280,280,280,280,280,280,280,280,280,280,280,280,280,280,280,280,280,280,280,280,280,280,280,280,280,280,280,280,280,280,280,280,280,280,280,280,280,280,280,280,280,280,280,280,280,280,280,280,280,280,280,280,280,280,280,280,280,280,280,280,280,280,280
280,280,280,280,280,280,280,280,280,280,280,280,280,280,280,280,280,280,280,280,280,280,280,280,280,280,280,280,280,280,280,280,280,280,280,280,280,280,280,280,280,280,280,280,280,280,280,280,280,280,280,280,280,280,280,280,280,280,280,280,280,280,280,280,280,280,280,280,280,280,280,280,280,280,280,280,280,280,280,280
280,280,280,280,280,280,280,280,280,280,280,280,280,280,280,280,280,280,280,280,280,280,280,280,280,280,280,280,280,280,280,280,280,280,280,280,280,280,280,280,280,280,280,280,280,280,280,280,280,280,280,280,280,280,280,280,280,280,280,280,280,280,280,280,280,280,280,280,280,280,280,280,280,280,280,280,280,280,280,280
280,280,280,280,280,280,280,280,280,280,280,280,280,280,280,280,280,280,280,280,280,280,280,280,280,280,280,280,280,280,280,280,280,280,280,280,280,280,280,280,280,280,280,280,280,280,280,280,280,280,280,280,280,280,280,280,280,280,280,280,280,280,280,280,280,280,280,280,280,280,280,280,280,280,280,280,280,280,280,280
280,280,280,280,280,280,280,280,280,280,280,280,280,280,280,280,280,280,280,280,280,280,280,280,280,280,280,280,280,280,280,280,280,280,280,280,280,280,280,280,280,280,280,280,280,280,280,280,280,280,280,280,280,280,280,280,280,280,280,280,280,280,280,280,280,280,280,280,280,280,280,280,280,280,280,280,280,280,280,280
280,280,280,280,280,280,280,280,280,280,280,280,280,280,280,280,280,280,280,280,280,280,280,280,280,280,280,280,280,280,280,280,280,280,280,280,280,280,280,280,280,280,280,280,280,280,280,280,280,280,280,280,280,280,280,280,280,280,280,280,280,280,280,280,280,280,280,280,280,280,280,280,280,280,280,280,280,280,280,280
280,280,280,280,280,280,280,280,280,280,280,280,280,280,280,280,280,280,280,280,280,280,280,280,280,280,280,280,280,280,280,280,280,280,280,280,280,280,280,280,280,280,280,280,55,55,55,55,55,55,55,55,55,55,55,55,55,55,55,55,280,280,280,280,280,280,280,280,280,280,280,280,280,280,280,280,280,280,280,280
280,280,280,280,280,280,280,280,280,280,280,280,280,280,280,280,280,280,280,280,280,280,280,280,280,280,280,280,280,280,280,280,280,280,280,280,280,280,280,280,280,280,55,55,55,55,55,55,137,55,55,55,55,182,55,55,55,55,55,0,1,2,280,280,280,280,280,280,280,280,280,280,280,280,280,280,280,280,280,280
280,280,280,280,280,280,280,280,280,280,280,280,280,280,280,280,280,280,280,280,280,280,280,280,280,280,280,280,280,280,280,280,280,280,280,280,280,280,280,280,0,1,2,55,55,55,55,55,180,55,55,55,55,55,181,55,55,55,55,45,46,60,1,2,280,280,280,280,280,280,280,280,280,280,280,280,280,280,280,280
280,280,280,280,280,280,280,280,280,280,280,280,280,280,280,280,280,280,280,280,280,280,280,280,280,280,280,280,280,280,280,280,280,280,280,280,280,55,0,1,61,46,47,55,137,55,55,55,55,55,137,55,182,135,181,55,55,55,55,90,16,46,46,47,55,55,280,280,280,280,280,280,280,280,280,280,280,280,280,280
280,280,280,280,280,280,280,280,280,280,280,280,280,280,280,280,280,280,280,280,280,280,280,280,280,280,280,280,280,280,280,280,280,280,280,0,1,1,61,46,46,46,47,55,55,55,181,55,55,55,55,55,55,55,181,55,137,182,55,55,90,16,46,60,2,55,55,55,280,280,280,280,280,280,280,280,280,280,280,280
280,280,280,280,280,280,280,280,280,280,280,280,280,280,280,280,280,280,280,280,280,280,280,280,280,280,280,280,280,280,280,280,280,280,1,61,46,46,183,46,15,91,92,55,55,55,55,55,55,181,55,55,55,55,55,55,55,55,55,55,55,45,46,46,47,55,55,55,55,55,280,280,280,280,280,280,280,280,280,280
280,280,280,280,280,280,280,280,280,280,280,280,280,280,280,280,280,280,280,280,280,280,280,280,280,280,280,280,280,280,280,280,55,45,184,138,184,139,46,139,47,55,55,55,55,55,55,181,181,55,55,55,55,55,55,55,55,55,55,55,55,90,16,46,47,55,55,55,55,55,55,280,280,280,280,280,280,280,280,280
280,280,280,280,280,280,280,280,280,280,280,280,280,280,280,280,280,280,280,280,280,280,280,280,280,280,280,280,280,280,0,1,1,61,46,46,139,46,46,46,47,55,55,55,55,55,55,55,182,55,55,55,55,55,55,182,55,55,181,55,55,55,45,46,47,55,55,55,55,55,55,55,55,280,280,280,280,280,280,280
280,280,280,280,280,280,280,280,280,280,280,280,280,280,280,280,280,280,280,280,280,280,280,280,280,280,280,280,0,1,61,46,139,46,46,15,91,16,139,46,47,55,55,182,55,55,55,55,55,55,55,55,55,55,55,55,55,182,55,137,181,55,45,46,60,2,55,55,55,55,55,55,55,55,55,280,280,280,280,280
280,280,280,280,280,280,280,280,280,280,280,280,280,280,280,280,280,280,280,280,280,280,280,280,280,280,280,0,61,46,46,46,46,185,15,92,0,61,185,46,47,55,55,55,55,55,137,55,55,55,55,55,55,55,55,55,55,136,55,55,55,55,45,46,46,60,2,55,55,55,55,55,55,55,55,55,55,280,280,280
280,280,280,280,280,280,280,280,280,280,280,280,280,280,280,280,280,280,280,280,280,280,280,280,280,280,280,45,46,46,46,46,46,46,47,0,61,46,46,15,92,55,55,135,55,55,182,55,55,55,55,135,55,181,55,55,55,55,55,55,55,0,61,46,46,46,47,55,55,55,55,55,55,55,55,55,55,55,280,280
280,280,280,280,280,280,280,280,280,280,280,280,280,280,280,280,280,280,280,280,280,280,280,280,0,1,1,61,46,46,46,46,46,46,60,61,46,46,15,92,55,55,55,55,55,136,55,55,55,55,181,55,55,55,55,55,55,55,55,55,0,61,46,46,46,46,47,55,55,55,55,55,55,55,55,55,55,55,55,55
280,280,280,280,280,280,280,280,280,280,280,280,280,280,280,280,280,280,280,280,280,280,0,1,61,46,46,46,46,46,46,46,183,46,46,140,15,91,92,55,55,55,55,55,55,55,55,55,55,55,55,55,55,135,55,55,55,55,55,55,45,139,46,46,46,46,60,2,55,55,55,55,55,55,55,55,55,55,55,55
280,280,280,280,280,280,280,280,280,280,280,280,280,280,280,280,280,280,280,280,0,1,61,46,46,46,46,46,46,46,46,183,46,46,15,91,92,55,55,55,55,55,55,55,55,55,55,55,55,55,55,180,135,180,55,55,55,55,55,55,45,185,46,46,46,46,46,47,55,55,55,55,55,55,55,55,55,55,55,55
280,280,280,280,280,280,280,280,280,280,280,280,280,280,280,280,280,55,55,55,45,46,46,46,46,46,46,46,46,46,138,46,15,91,92,55,55,55,55,55,55,181,55,55,55,55,55,55,55,55,55,55,182,55,55,55,55,55,55,55,45,183,46,46,15,91,16,47,55,55,55,55,55,55,55,55,55,55,55,55
280,280,280,280,280,280,280,280,280,280,280,280,280,55,55,55,55,55,55,55,90,16,46,46,46,184,46,46,46,46,15,91,92,55,55,55,55,55,55,55,55,55,55,55,55,55,55,55,55,55,55,55,55,55,55,55,55,55,55,55,90,16,184,46,60,2,90,92,55,55,55,55,55,55,55,55,55,55,55,55
55,55,55,55,55,55,55,55,55,55,55,55,55,55,55,135,55,55,55,55,55,90,91,16,46,46,46,46,15,91,92,55,55,137,55,136,55,55,55,55,55,55,55,55,55,55,55,136,55,55,55,55,55,55,55,55,55,55,55,55,55,45,46,46,46,60,2,55,55,55,55,55,55,55,55,55,55,55,55,55
55,55,55,55,55,55,55,55,55,55,55,55,55,55,136,55,55,55,55,136,55,55,55,90,91,91,91,91,92,55,55,55,55,135,55,55,55,55,55,55,55,55,55,55,182,55,55,55,55,55,55,55,55,55,55,55,55,55,137,55,55,45,46,46,46,46,60,2,55,55,55,55,55,55,55,55,55,55,55,55
55,55,181,55,55,55,55,55,55,55,182,55,55,55,55,55,55,55,55,55,55,55,55,55,55,55,55,55,136,55,55,136,136,55,55,55,55,55,55,55,55,55,137,55,55,55,55,55,55,55,55,55,55,182,55,55,55,55,55,55,55,90,16,46,46,46,46,47,55,55,55,55,55,55,55,55,55,55,55,55
55,55,55,55,55,55,55,55,55,55,55,182,55,55,55,55,55,180,55,55,55,55,55,55,55,55,55,55,55,55,55,55,55,55,55,55,55,55,55,136,55,55,55,55,55,55,55,55,55,55,55,55,55,135,55,55,55,55,55,55,55,55,90,91,16,46,46,60,2,55,55,55,55,55,55,55,55,55,55,55
55,55,55,55,55,55,55,55,55,55,55,55,55,55,55,180,55,55,55,55,55,55,55,55,55,55,55,55,55,55,55,55,55,55,55,55,55,55,182,55,55,55,55,55,55,55,55,55,55,55,55,55,55,55,55,55,55,55,55,55,55,55,55,55,45,46,46,46,60,2,55,55,55,55,55,55,55,55,55,55
55,55,137,55,55,55,55,55,55,181,55,55,55,55,55,55,55,55,55,55,55,55,55,55,55,182,55,180,182,55,55,55,55,55,55,55,55,55,55,55,55,55,55,55,55,55,135,55,55,55,55,55,55,55,55,55,55,135,55,55,55,55,55,55,45,46,138,46,46,47,55,55,55,55,55,55,55,55,55,55
55,55,55,55,55,55,55,55,55,181,55,55,55,55,55,55,55,55,55,55,55,55,182,55,55,180,55,55,55,55,137,55,55,55,55,55,55,55,55,55,55,55,55,55,55,55,55,55,55,55,55,55,55,55,55,55,55,55,55,55,55,55,55,55,90,16,46,140,46,60,1,2,55,55,55,55,55,55,55,55
55,55,55,55,55,55,55,180,55,55,55,55,55,55,55,55,55,55,55,55,55,55,55,55,55,55,55,55,55,55,55,55,55,55,181,55,55,55,55,55,55,55,55,55,182,55,55,55,55,55,55,55,55,55,55,55,55,55,55,55,55,55,137,55,55,90,91,16,46,46,46,60,2,55,55,55,55,55,55,55
55,55,55,55,55,55,182,55,55,55,55,136,55,55,55,55,55,55,55,55,55,55,55,55,55,55,55,55,55,55,55,55,55,55,182,55,55,55,55,55,55,55,55,55,55,55,55,55,55,55,55,55,55,55,55,55,55,55,55,55,55,55,55,55,55,55,55,45,139,46,46,46,60,2,55,55,55,55,55,55
55,55,55,55,55,135,55,55,55,55,55,55,55,55,55,55,55,55,55,55,55,55,55,55,55,55,55,55,55,55,55,55,55,55,55,55,55,55,55,55,55,55,55,55,55,55,55,55,55,55,55,55,55,55,55,55,55,55,55,55,55,55,55,55,55,55,55,90,16,185,46,46,46,47,55,55,55,55,55,55
55,55,181,55,55,55,55,55,55,55,55,55,55,55,55,55,55,55,181,55,55,55,55,137,137,55,55,55,55,55,55,135,55,55,55,55,55,55,55,55,55,55,55,136,55,55,55,55,55,55,55,55,55,55,55,55,55,55,55,55,55,55,55,55,55,55,55,55,45,46,46,184,46,60,2,55,55,55,55,55
55,55,55,55,55,55,55,55,55,55,55,55,55,55,55,55,136,55,55,55,55,55,181,55,55,55,55,55,55,55,55,55,55,55,55,55,55,55,55,55,55,55,181,55,55,55,55,55,55,55,55,55,55,55,55,55,55,55,55,55,55,55,55,55,55,55,55,55,90,91,16,140,46,46,60,2,55,55,55,55
55,55,55,55,55,55,55,55,55,0,1,1,1,2,55,55,55,55,55,55,55,55,55,55,55,55,55,55,55,55,135,55,55,55,55,55,55,55,55,55,55,55,55,55,55,55,55,55,55,55,55,55,55,55,55,182,55,55,181,182,55,55,55,55,55,55,55,55,55,55,90,16,139,46,46,60,2,55,55,55
55,55,55,55,0,1,1,1,1,61,46,46,46,60,2,55,55,55,55,55,55,55,55,55,55,55,55,55,55,55,55,55,55,55,55,55,55,55,55,55,55,55,55,55,55,182,55,55,55,55,55,55,55,55,55,55,55,55,55,55,55,55,55,55,55,55,55,55,55,55,55,90,16,46,46,46,60,2,55,55
55,55,0,1,61,46,185,46,46,46,185,185,46,46,60,1,1,1,2,55,55,55,55,55,55,55,55,55,0,1,1,1,1,1,1,1,1,1,1,1,1,2,55,55,55,55,55,55,55,55,181,55,55,55,55,55,55,55,55,55,55,55,55,55,55,182,55,55,55,55,55,55,90,16,46,46,46,47,55,55
1,1,61,46,46,138,140,46,140,46,46,46,46,46,184,140,46,46,60,1,1,1,1,1,1,1,1,1,61,46,46,46,46,46,46,46,46,46,46,46,46,60,1,2,55,55,55,55,182,55,55,55,55,55,55,182,55,55,55,55,55,55,55,55,55,55,55,55,55,55,55,55,55,45,46,46,46,60,1,2
16,46,46,46,46,46,46,46,46,185,46,46,46,46,46,46,46,46,46,46,46,46,46,46,46,46,46,46,46,46,46,15,16,183,46,46,46,46,46,15,91,16,46,60,2,55,55,55,55,55,55,55,137,55,55,55,55,55,55,55,55,55,136,55,55,55,55,55,55,55,55,55,55,90,16,46,46,46,46,60
45,46,46,46,46,46,46,46,46,46,46,46,46,46,46,46,46,46,46,46,46,140,46,46,46,46,46,46,46,46,46,60,61,138,46,46,46,46,185,60,1,61,46,46,60,1,2,55,55,55,55,55,55,55,182,55,55,55,55,55,182,55,55,182,55,55,55,55,55,55,55,55,55,55,90,16,46,46,46,46
61,46,46,46,46,46,46,46,46,46,46,46,46,46,46,46,46,46,46,46,46,46,46,46,46,46,183,138,46,46,46,46,46,138,46,46,46,46,46,46,46,46,46,46,46,46,60,2,55,55,55,55,55,55,55,55,55,55,55,55,55,55,55,55,55,135,180,55,55,55,55,55,55,55,55,90,16,46,46,46
46,46,46,46,46,46,46,46,46,46,46,46,46,46,46,46,46,46,46,46,46,46,46,46,46,46,46,46,46,46,46,46,46,46,46,46,46,46,46,46,46,46,15,91,16,46,46,60,2,55,55,55,55,55,55,55,55,55,55,55,55,55,55,55,55,55,55,55,55,55,55,55,55,55,55,55,90,16,46,46
46,46,46,46,46,46,46,46,46,46,46,46,46,46,46,46,46,46,46,46,46,46,46,46,46,46,46,46,46,46,46,46,46,46,46,46,46,46,46,184,46,46,60,1,61,46,46,46,47,55,55,55,55,55,55,55,55,55,136,55,55,55,55,55,180,55,55,136,55,55,55,55,55,55,55,55,55,45,140,138
46,46,46,46,46,46,46,46,46,46,46,46,46,46,46,46,46,46,46,46,46,46,46,46,46,46,46,46,46,46,46,46,46,46,46,46,46,46,46,46,46,46,46,46,46,46,15,16,60,2,55,55,55,55,55,55,55,55,55,55,55,55,55,55,55,55,55,55,55,55,55,55,55,55,55,55,55,45,46,46
46,46,46,46,46,46,46,46,46,46,46,46,46,46,46,46,46,46,46,46,46,46,46,46,46,46,46,46,46,46,46,46,46,46,46,46,46,46,46,46,46,46,46,46,46,46,60,61,46,60,2,55,55,55,55,55,55,55,55,55,55,55,55,55,55,55,55,55,55,55,136,55,55,55,55,55,55,90,91,16
46,46,46,46,46,46,46,46,46,46,46,46,46,46,46,46,46,46,46,46,46,46,46,46,46,46,46,46,46,46,46,46,46,46,46,46,46,46,46,46,46,46,46,46,46,183,46,46,46,46,47,55,55,55,55,55,55,55,136,55,180,55,55,55,55,55,55,55,55,55,55,55,55,55,55,55,55,55,55,90
46,46,46,46,46,46,46,46,46,46,46,46,46,46,46,46,46,46,46,46,46,46,46,46,46,46,46,46,46,46,46,46,46,46,46,46,46,46,46,46,46,46,46,46,46,46,46,46,46,46,47,55,55,55,55,55,55,55,55,55,55,55,55,55,55,55,55,55,55,55,55,55,55,55,55,55,55,55,55,55
46,46,46,46,46,46,46,46,46,46,46,46,46,46,46,46,46,46,46,46,46,46,46,46,46,46,46,46,46,46,46,46,46,46,46,46,46,46,46,46,46,46,46,46,46,46,46,46,46,46,60,2,55,55,55,55,55,55,55,55,55,55,55,55,55,55,55,55,55,55,55,55,55,55,55,55,55,55,55,55
46,46,46,46,46,46,46,46,46,46,46,46,46,46,46,46,46,46,46,46,46,46,46,46,46,46,46,46,46,46,46,46,46,46,46,46,46,46,46,46,46,46,46,46,46,46,46,46,46,46,46,60,2,55,55,55,55,55,55,55,55,55,55,55,55,55,55,55,55,55,55,55,55,55,55,55,55,55,55,55
46,46,46,46,46,46,46,46,46,46,46,46,46,46,46,46,46,46,46,46,46,46,46,46,46,46,46,46,46,46,46,46,46,46,46,46,46,46,46,46,46,46,46,46,46,46,46,46,139,46,46,46,60,1,1,2,55,55,55,55,55,55,55,55,55,55,55,55,55,55,55,55,55,55,55,55,55,55,55,55
46,46,46,46,46,46,46,46,46,46,46,46,46,46,46,46,46,46,46,46,46,46,46,46,46,46,46,46,46,46,46,46,46,46,46,46,46,46,46,46,46,46,46,46,46,46,46,46,46,46,46,46,46,46,46,60,2,55,55,55,55,55,55,55,55,55,55,55,55,55,55,55,55,55,55,55,55,55,55,55
46,46,46,46,46,46,46,46,46,46,46,46,46,46,46,46,46,46,46,46,46,46,46,46,46,46,46,46,46,46,46,46,46,46,46,46,46,46,46,46,46,46,46,46,46,46,46,46,46,46,46,46,46,46,46,46,60,2,55,55,55,55,55,55,55,55,55,55,55,55,55,55,136,55,55,55,55,55,55,55
46,46,46,46,46,46,46,46,46,46,46,46,46,46,46,46,46,46,46,46,46,46,46,46,46,46,46,46,46,46,46,46,46,46,46,46,46,46,46,46,46,46,46,46,46,46,46,46,46,46,46,46,46,46,139,46,46,60,2,55,55,55,55,55,55,55,55,55,55,55,55,55,55,55,55,55,55,55,55,55
46,46,46,46,46,46,46,46,46,46,46,46,46,46,46,46,46,46,46,46,46,46,46,46,46,46,46,46,46,46,46,46,46,46,46,46,46,46,46,46,46,46,46,46,46,46,46,46,46,46,46,46,46,46,184,46,46,46,60,2,55,55,55,55,55,55,55,55,55,55,55,55,55,55,55,55,55,55,55,55
46,46,46,46,46,46,46,46,15,16,46,46,46,46,46,184,46,46,46,46,46,46,46,46,46,46,46,46,46,46,46,46,46,46,46,46,46,46,46,46,46,46,46,46,46,46,46,46,46,46,46,46,15,16,46,46,46,46,46,60,1,1,2,55,55,55,55,55,55,55,55,55,55,55,55,55,55,55,55,55
46,46,46,46,46,46,46,46,60,61,46,46,46,46,46,140,46,46,46,46,46,46,46,46,46,46,46,46,46,46,46,46,46,46,46,46,46,46,46,46,46,46,46,46,46,46,46,46,46,46,46,46,60,61,46,46,46,46,46,46,46,46,60,2,55,55,55,55,55,55,55,55,55,55,55,181,55,55,55,55
46,46,46,15,16,46,46,46,46,46,46,46,46,46,185,140,46,46,46,46,46,46,46,46,46,184,46,46,46,46,46,46,46,46,46,46,46,46,46,46,46,46,46,46,46,46,46,46,46,46,46,46,46,46,46,46,46,46,46,183,46,46,46,60,2,55,55,55,55,55,55,55,55,55,55,55,55,55,55,55
139,46,46,60,61,46,46,46,46,46,140,184,46,46,15,91,91,16,15,91,16,46,46,46,46,46,183,46,15,91,16,46,46,46,46,46,46,46,46,46,46,46,46,46,46,46,46,46,46,46,46,46,46,46,46,46,46,46,46,46,46,46,46,46,47,55,55,55,55,55,55,55,55,55,55,55,55,55,55,180
46,46,46,46,183,183,46,46,46,46,46,46,15,91,92,55,55,90,60,2,45,46,46,185,185,185,183,139,60,1,61,46,46,46,46,46,46,46,46,46,46,46,46,46,46,46,46,46,46,46,46,46,46,46,46,46,46,46,46,46,46,46,46,46,47,55,55,55,55,55,55,55,55,55,55,55,55,55,55,55
91,91,91,91,91,91,91,91,91,91,91,91,92,55,55,55,55,55,90,60,61,46,46,46,46,46,46,46,46,46,46,46,46,46,46,46,46,46,46,46,46,46,46,46,46,46,46,46,46,46,46,46,46,46,46,46,46,46,46,46,46,46,46,46,47,55,55,55,55,55,55,137,55,55,55,55,181,55,55,55
55,55,55,55,55,55,55,55,55,55,55,55,55,55,55,55,55,55,55,45,46,46,46,46,46,46,46,46,46,46,46,46,46,185,46,46,46,46,46,46,46,46,46,46,46,46,46,46,46,46,46,46,46,46,46,46,46,46,46,46,46,139,46,46,60,2,55,55,55,181,55,55,180,55,55,55,55,55,55,55
55,55,182,55,55,55,55,55,55,55,182,55,55,55,55,180,55,55,55,90,91,91,91,91,91,91,91,91,16,46,46,46,15,16,184,46,46,46,46,46,46,46,46,46,46,46,46,46,46,46,46,46,46,46,46,46,46,46,46,46,46,46,46,46,46,60,2,55,55,55,55,55,55,55,55,55,55,55,55,55
55,135,55,55,137,137,55,55,55,55,55,55,55,55,55,55,55,55,55,55,55,55,55,55,55,55,55,55,90,16,46,46,60,61,46,46,46,46,46,46,46,46,46,46,46,46,46,46,46,46,46,46,46,46,46,46,46,46,46,46,46,46,46,46,46,46,60,1,2,55,182,55,55,55,55,55,55,55,181,55
55,55,55,55,55,55,55,181,55,55,55,55,182,55,55,55,55,55,55,55,135,55,55,55,55,55,55,55,55,90,16,46,46,46,46,15,16,46,46,46,46,46,46,46,46,46,46,46,46,46,46,46,46,46,46,46,46,46,46,46,46,46,46,46,46,46,46,46,60,2,55,55,137,55,55,55,55,55,55,55
55,137,55,55,55,55,55,55,55,55,55,55,55,55,55,137,55,55,55,55,55,55,55,55,55,55,55,181,55,55,90,91,16,46,138,60,61,46,46,46,46,46,46,46,46,46,46,46,46,46,46,46,46,46,46,46,46,46,46,46,46,46,46,46,46,46,46,46,46,60,1,2,55,55,55,55,55,55,55,55
55,55,55,55,55,55,55,55,55,55,55,136,55,55,55,136,55,180,55,55,137,181,55,137,55,55,55,55,55,55,55,55,90,91,16,140,46,46,46,46,46,46,46,185,46,46,46,46,46,46,46,46,46,46,46,46,46,46,46,46,46,46,46,46,139,46,46,46,46,46,46,60,2,55,55,135,55,55,55,55
55,55,180,55,55,136,55,55,55,55,55,55,55,55,55,137,55,55,55,55,55,55,55,55,55,55,55,55,136,55,55,55,55,55,90,91,91,91,91,91,91,16,46,46,46,46,46,46,46,46,46,185,46,46,46,185,139,185,46,46,46,46,46,46,46,46,46,46,15,91,16,46,60,2,55,55,55,55,55,55
55,55,55,55,55,55,55,55,55,55,55,55,55,55,55,55,55,55,55,55,55,55,55,135,55,55,55,137,55,55,55,55,55,55,55,55,55,55,55,55,55,90,16,46,46,46,46,46,46,46,46,139,46,46,46,46,46,46,46,46,46,46,46,46,46,46,46,46,60,2,45,46,46,47,55,182,55,55,55,55
55,55,55,55,55,0,1,1,1,1,1,1,2,55,55,55,180,55,55,55,55,55,55,55,55,55,55,55,55,55,55,55,55,55,55,55,55,55,55,55,55,55,90,16,46,46,46,46,46,46,46,46,46,46,46,46,46,46,46,46,46,46,46,46,46,46,46,46,184,60,61,46,46,47,55,55,55,55,55,55
55,55,55,0,1,61,46,46,46,140,46,46,60,1,2,55,55,55,55,55,55,55,55,55,55,55,136,181,55,55,55,55,137,182,55,55,55,55,55,55,55,55,55,90,91,16,46,46,46,46,46,46,46,46,46,46,46,46,46,46,46,46,46,46,46,46,46,46,138,46,46,46,46,47,55,55,55,55,55,135
55,55,0,61,46,46,46,46,46,46,46,46,46,46,60,2,55,55,55,55,55,55,55,55,55,180,55,55,55,55,55,55,55,55,55,55,55,136,55,55,55,55,55,55,55,90,91,91,91,16,46,46,46,46,46,46,46,46,46,46,46,46,46,46,46,46,46,46,46,46,46,15,91,92,180,55,55,55,55,55
55,0,61,46,46,140,183,46,46,46,46,15,16,46,46,60,1,1,1,1,2,55,55,55,55,55,55,55,55,182,180,55,55,137,55,55,55,55,55,55,55,55,55,55,55,55,55,55,55,45,46,140,46,46,46,46,46,46,46,46,140,46,46,46,46,46,46,46,46,46,46,47,55,55,55,55,55,55,55,55
1,61,46,46,46,46,46,46,46,46,46,60,61,46,46,46,46,46,46,46,60,1,2,55,55,55,55,55,181,55,55,55,55,55,55,55,55,55,55,55,137,55,55,55,55,55,55,55,55,90,16,46,46,46,46,46,46,46,46,46,183,46,46,46,46,46,46,185,46,46,15,92,55,55,55,55,55,55,55,55
139,46,46,46,139,46,46,46,46,46,46,46,46,46,46,15,91,91,16,46,46,46,60,2,55,55,55,55,182,55,55,55,55,55,55,55,55,55,55,55,55,181,55,55,55,55,55,55,55,55,90,91,91,91,91,91,91,16,46,15,91,91,91,16,46,46,46,139,46,15,92,55,55,55,55,55,55,55,55,55
46,46,46,46,46,46,46,46,46,46,46,46,46,46,46,60,1,1,61,46,15,16,46,60,1,1,2,55,55,55,55,55,182,55,55,181,55,55,55,55,55,55,55,55,55,181,181,55,55,55,55,55,55,55,55,55,55,45,46,60,1,1,1,61,46,15,91,91,91,92,55,55,55,55,55,55,55,181,55,55
46,46,46,46,46,46,46,46,46,46,46,46,46,46,46,46,46,46,46,46,60,61,46,46,46,183,60,1,1,2,55,55,55,55,55,55,55,55,55,55,55,55,55,55,55,55,55,55,55,55,55,55,55,181,55,180,55,90,16,46,46,46,46,46,46,47,55,55,55,55,55,55,55,55,181,55,55,55,55,55
46,46,46,46,46,46,46,46,46,46,46,46,46,46,46,46,46,46,46,46,46,46,184,46,46,46,140,46,46,60,1,1,2,55,55,55,55,55,55,181,55,55,55,55,55,55,55,55,55,55,55,55,135,55,182,55,55,55,90,91,91,91,91,91,91,92,55,55,55,55,55,55,55,55,137,55,55,55,55,136
46,46,46,46,46,46,46,46,46,46,46,46,46,46,46,46,46,46,46,46,46,46,46,184,183,46,46,46,46,46,46,46,60,2,55,55,55,136,55,55,55,55,55,55,55,55,55,55,136,55,55,55,55,55,55,55,55,55,181,55,55,55,55,55,55,55,55,55,55,55,55,55,55,55,55,55,55,55,55,55
46,46,46,46,46,46,46,46,46,46,46,46,46,46,46,46,46,46,46,46,46,46,46,46,46,46,46,46,46,183,46,46,46,60,1,1,1,1,1,136,2,55,135,55,55,55,55,55,55,137,55,55,55,55,55,55,55,55,55,55,55,55,55,55,55,55,55,55,55,55,55,55,55,55,55,55,55,55,55,55
46,46,46,46,46,46,46,46,46,46,46,46,46,46,46,46,46,46,46,46,46,46,46,46,139,183,46,46,46,46,46,139,46,46,46,46,46,46,46,46,60,1,2,55,55,55,180,55,55,55,55,55,182,55,55,55,55,55,55,135,55,55,55,55,55,55,55,55,55,55,55,182,55,55,55,55,55,55,55,55
