505,505,505,505,505,505,505,505,505,505,505,505,505,505,505,505,505,505,505,505,505,505,505,505,505,505,505,505,505,505,505,505,505,505,505,505,505,495,496,496,589,496,588,465,541,541,542,505,505,505,505,585,505,505,505,505,505,450,511,496,510,511,496,496,496,496,496,496,496,496,496,496,496,496,496,496,496,496,496,496
505,505,505,505,505,505,505,505,505,505,505,505,630,631,505,505,505,505,505,505,505,505,505,505,505,505,505,505,505,505,505,505,505,505,505,450,451,511,496,465,466,496,465,542,505,505,505,505,505,505,505,505,505,505,505,450,451,511,496,496,496,496,496,496,496,496,496,496,496,496,496,496,496,496,496,496,496,496,496,496
505,505,505,505,505,505,505,505,505,505,505,505,505,505,505,505,505,505,505,505,505,505,505,505,505,505,505,505,505,505,505,505,505,450,451,511,635,496,465,542,540,541,542,505,505,505,505,505,505,505,505,505,450,451,451,511,496,496,496,496,496,496,496,496,496,496,496,496,496,496,496,496,496,496,496,496,496,496,496,496
505,505,505,505,505,505,505,505,505,505,505,505,505,505,585,505,505,505,505,505,505,505,505,505,505,585,505,505,505,505,505,505,450,511,496,496,588,465,542,505,505,505,505,505,505,505,450,451,451,451,451,451,511,496,496,496,496,496,496,496,496,496,496,496,496,496,496,496,496,496,496,496,496,496,496,496,496,496,496,496
505,505,505,505,505,505,585,585,505,505,630,505,505,505,505,505,505,505,505,505,505,505,505,505,505,505,505,505,505,505,450,451,511,496,496,465,541,542,505,505,505,505,586,505,450,451,511,496,496,496,496,496,496,496,496,496,496,496,496,496,496,496,496,496,496,496,496,496,496,496,496,496,496,496,496,496,496,496,496,496
505,505,505,505,505,505,505,505,505,505,505,505,505,505,505,505,505,505,505,505,505,505,505,505,505,505,505,505,450,451,511,588,496,465,541,542,505,505,505,505,630,505,450,451,511,496,496,496,496,496,496,496,496,496,496,496,496,496,496,496,496,496,496,496,496,496,496,496,496,496,496,496,496,496,496,496,496,496,496,496
505,505,505,505,505,505,505,505,505,505,505,505,505,505,505,505,505,587,505,505,505,505,505,505,505,505,450,451,511,496,588,496,465,542,505,505,505,505,505,505,450,451,511,496,496,496,496,496,496,496,496,496,496,496,496,496,496,496,496,496,496,496,496,496,496,496,496,496,496,496,496,496,496,496,496,496,496,496,496,496
505,505,630,505,505,505,505,505,505,505,505,505,505,505,505,505,505,505,505,505,505,505,505,505,450,451,511,496,496,496,465,541,542,505,505,586,505,505,450,451,511,496,496,496,496,496,496,496,496,496,496,496,496,496,496,496,496,496,496,496,496,496,496,496,496,496,496,496,496,496,496,496,496,496,496,496,496,496,496,496
505,505,505,505,505,505,585,505,505,505,505,505,585,505,505,505,505,505,505,505,505,505,450,451,511,633,496,496,465,541,542,505,505,631,505,505,450,451,511,496,496,496,496,496,496,496,496,496,496,496,496,496,496,496,496,496,496,496,496,496,496,496,496,496,496,496,496,496,496,496,496,496,496,496,496,496,496,496,634,496
505,505,505,630,505,505,505,505,505,505,505,505,505,505,505,505,505,505,450,451,451,451,511,496,635,496,465,541,542,631,505,505,505,505,450,451,511,496,496,496,496,496,496,496,496,496,496,496,496,496,496,496,496,496,496,496,496,496,496,496,496,496,496,496,496,496,496,496,496,496,496,496,496,496,496,496,496,496,588,496
505,505,505,505,505,505,505,505,505,505,505,505,505,505,505,505,450,451,511,496,496,590,496,496,496,465,542,505,505,505,505,450,451,451,511,496,496,496,496,496,496,496,496,496,496,496,496,496,496,496,496,496,496,496,496,496,589,588,496,496,496,496,496,496,496,496,496,496,496,496,496,590,635,496,496,496,496,496,496,496
505,505,505,505,505,505,505,505,505,505,505,505,505,450,451,451,511,496,496,635,590,589,496,465,541,542,505,505,631,450,451,511,496,496,496,496,496,496,496,496,496,496,496,496,496,496,496,496,496,496,496,496,496,496,496,496,496,634,496,496,496,496,496,496,496,496,496,496,496,496,496,496,496,496,496,496,496,635,496,633
505,505,505,505,505,505,505,505,505,505,505,505,450,511,496,496,496,496,496,496,496,465,541,542,505,505,587,505,505,495,496,496,496,496,496,496,496,496,496,496,496,496,496,496,496,496,496,496,496,496,496,496,496,496,496,496,496,496,496,496,496,496,496,496,496,496,496,496,496,496,496,496,496,496,496,496,633,496,634,496
505,505,505,505,505,505,505,505,505,505,450,451,511,496,496,635,634,589,588,496,465,542,505,631,631,505,505,450,451,511,496,496,496,496,496,496,496,496,496,496,496,496,496,496,496,496,496,496,496,496,496,496,496,496,496,496,633,496,496,496,496,496,496,496,496,496,496,496,496,496,496,590,496,496,633,496,496,589,496,496
505,505,505,505,505,505,505,450,451,451,511,496,496,496,496,496,496,496,465,541,542,505,505,505,505,450,451,511,496,496,496,496,496,496,496,496,496,496,496,496,496,496,496,496,496,496,496,496,496,496,496,496,496,496,496,496,633,590,590,590,589,496,496,496,496,496,634,496,496,496,496,496,496,496,589,496,496,496,496,496
505,505,505,505,505,505,505,495,496,496,496,496,496,496,496,465,541,541,542,630,505,505,505,450,451,511,496,496,496,496,496,496,496,496,496,496,496,496,496,496,496,496,496,496,496,496,496,496,496,496,496,496,496,590,589,496,496,496,496,496,496,496,496,496,588,635,496,590,588,496,496,633,496,590,588,496,496,496,496,465
505,505,505,505,505,505,450,511,496,496,496,496,496,465,541,542,505,505,505,586,505,505,450,511,496,496,496,496,496,496,496,496,496,496,496,496,496,496,496,496,496,496,496,496,496,496,496,496,633,590,496,496,496,496,496,635,496,496,496,496,496,496,496,496,496,635,634,496,496,590,633,496,496,496,496,496,465,541,541,542
505,505,505,505,450,451,511,496,496,496,496,496,496,497,505,505,505,505,586,505,450,451,511,496,496,496,496,496,496,496,496,496,496,496,496,496,496,496,496,496,496,496,496,496,496,496,496,496,589,588,496,496,496,588,496,496,634,633,496,496,496,496,496,496,496,496,588,635,588,496,496,496,496,465,541,541,542,505,505,505
505,505,450,451,511,496,496,496,496,496,496,496,465,542,505,505,630,505,505,450,511,496,496,496,496,496,496,496,496,496,496,496,496,496,496,496,496,496,496,496,496,496,496,496,496,496,496,496,496,496,496,635,496,496,496,496,634,496,633,496,496,496,496,496,496,496,465,541,541,541,541,541,541,542,505,505,505,505,505,505
505,450,511,496,496,496,496,496,496,496,496,465,542,505,505,505,505,505,450,511,496,496,496,496,496,496,496,496,496,496,633,496,496,496,496,496,496,496,496,496,496,465,541,541,541,466,496,496,496,496,496,633,496,496,496,496,496,496,496,496,496,496,496,496,465,541,542,505,505,505,505,505,505,505,505,505,505,505,505,505
505,495,496,496,496,496,496,496,496,496,465,542,505,630,587,505,505,450,511,496,496,496,496,496,496,496,496,496,496,496,496,496,496,496,633,634,496,496,496,496,465,542,505,505,505,540,541,541,466,496,496,496,496,496,496,496,496,496,496,465,541,541,541,541,542,505,505,505,505,505,505,505,505,505,505,505,505,505,505,505
451,511,496,496,496,496,496,496,465,541,542,505,505,505,586,505,505,495,496,496,496,496,496,496,496,496,496,496,496,496,496,496,496,496,496,496,465,541,541,541,542,631,505,505,505,630,505,505,540,541,541,541,541,541,541,541,541,541,541,542,505,505,505,505,505,505,505,505,505,505,505,505,505,505,585,505,505,505,505,505
496,496,496,496,496,496,496,465,542,505,505,505,505,630,587,505,505,495,496,496,496,496,496,496,496,496,496,496,496,496,496,634,496,496,496,465,542,505,505,505,505,505,505,505,505,505,505,505,505,505,505,505,505,505,505,505,505,505,505,505,505,505,505,505,505,505,505,505,505,505,505,505,505,505,585,505,505,505,505,505
496,496,496,496,496,496,496,497,505,505,587,505,505,505,505,632,505,495,496,496,496,496,496,496,496,496,496,496,496,496,496,465,541,541,541,542,505,505,586,505,505,505,630,505,505,631,505,505,505,505,505,505,505,505,505,505,631,505,505,505,505,585,505,505,505,505,505,505,505,632,505,505,505,505,505,505,505,505,505,505
496,496,496,496,496,496,496,497,505,505,505,505,505,450,451,451,451,511,496,496,496,496,496,496,496,496,496,590,635,496,496,497,505,505,505,505,505,505,505,505,505,505,505,505,505,505,505,505,505,505,505,505,505,505,505,505,585,505,505,505,505,505,505,505,505,505,505,505,505,632,505,505,505,505,505,505,505,505,505,505
496,496,496,496,496,465,541,542,505,632,505,450,451,511,496,496,496,496,496,496,496,496,496,496,496,496,633,496,496,496,496,497,505,505,505,630,505,631,585,505,505,505,505,505,505,505,632,505,505,505,505,505,505,505,631,505,505,505,505,587,505,505,505,505,505,505,505,505,505,505,505,505,505,630,505,505,505,505,505,505
496,496,496,496,465,542,505,505,505,505,505,495,496,496,496,496,496,496,496,496,496,496,496,496,496,496,589,588,496,496,496,497,505,505,505,630,505,505,505,505,505,505,505,505,505,505,505,587,505,505,505,505,505,505,505,505,505,505,505,505,505,505,505,505,505,586,505,505,505,505,505,505,505,505,505,505,505,586,585,505
496,465,541,541,542,505,505,632,632,505,505,495,496,496,496,496,496,496,496,496,496,496,496,496,496,496,496,496,496,496,465,542,505,505,505,505,505,505,505,505,505,505,505,505,505,505,505,505,505,505,505,505,505,505,505,505,505,505,505,505,505,505,505,505,587,630,631,505,505,505,505,505,585,587,505,505,505,505,585,505
541,542,505,505,505,505,505,505,505,505,505,540,466,496,496,496,496,496,496,496,496,496,496,496,496,496,496,496,496,465,542,505,505,505,505,505,505,585,505,505,505,505,587,505,505,505,505,505,505,505,505,505,505,505,505,505,505,505,505,505,505,505,585,505,505,505,505,505,505,505,505,505,505,632,505,505,505,505,505,505
505,505,505,505,505,505,505,505,505,505,450,451,511,496,496,496,496,496,496,496,496,496,496,496,496,496,496,496,465,542,505,505,505,505,505,505,505,630,585,505,505,505,505,505,505,505,505,505,505,505,505,505,505,505,505,505,505,505,505,586,505,505,585,505,505,505,505,505,505,505,505,505,505,505,505,505,505,505,505,505
505,505,505,505,505,505,505,450,451,451,511,496,496,496,496,496,496,496,496,633,496,496,496,496,496,496,465,541,542,505,505,505,505,505,505,505,505,505,505,505,505,505,505,505,505,505,505,505,505,505,505,505,505,505,505,505,505,505,505,505,505,505,505,505,505,505,505,505,505,505,505,505,505,505,505,505,505,505,505,587
505,505,505,505,505,505,450,511,496,496,496,496,496,496,496,496,496,496,496,590,496,496,496,496,465,541,542,505,505,505,505,587,505,505,505,505,505,505,505,505,505,630,505,505,505,505,505,505,505,505,505,505,505,505,505,505,505,631,505,505,505,505,505,505,505,505,505,505,505,505,505,505,586,505,505,505,505,505,505,585
631,505,505,505,450,451,511,496,496,496,496,588,588,496,496,496,496,635,496,633,496,496,496,496,497,505,505,505,505,505,505,505,505,505,505,505,505,505,505,505,505,505,505,505,505,505,505,505,505,505,505,505,505,505,505,505,587,505,505,505,505,505,505,631,505,505,505,505,505,505,505,505,505,505,505,505,505,505,505,505
505,505,505,450,511,496,496,496,496,496,496,496,496,496,496,496,589,496,496,496,496,496,465,541,542,505,505,505,505,505,505,585,505,505,505,505,505,505,505,505,505,505,505,505,505,505,632,505,505,505,505,505,505,587,631,505,505,505,505,505,505,505,505,587,505,505,505,505,505,505,505,505,586,632,505,505,505,505,505,505
505,450,451,511,496,496,496,496,496,496,496,496,496,496,496,496,496,496,496,496,496,465,542,505,505,505,585,505,505,632,505,586,505,505,505,505,631,505,505,586,505,505,505,505,505,505,505,505,585,587,505,505,505,505,505,505,505,585,505,505,505,505,505,505,505,505,505,505,505,505,505,630,630,505,632,586,505,505,505,505
450,511,496,496,496,496,496,496,496,496,496,496,496,496,634,496,496,496,496,496,465,542,505,505,505,505,505,505,505,505,505,505,505,505,505,505,505,505,505,505,505,505,505,505,505,505,505,505,505,505,505,505,505,505,505,505,505,505,505,505,505,630,587,505,505,505,505,505,630,632,505,505,505,505,505,505,505,505,505,505
511,496,496,633,496,496,496,496,496,496,496,496,496,496,589,496,496,496,496,465,542,505,505,505,505,505,505,505,505,505,505,505,505,505,505,505,505,505,505,505,505,505,505,505,505,505,505,505,505,505,505,505,505,505,505,505,505,505,505,505,505,505,505,505,505,505,587,631,631,505,505,505,505,505,505,505,505,505,505,505
496,496,589,496,496,496,496,496,496,496,496,496,496,589,496,496,496,496,496,497,505,505,505,505,630,505,505,630,505,505,505,505,587,505,505,505,505,505,505,505,505,505,505,505,505,505,505,505,505,505,505,505,505,505,505,505,505,505,505,505,505,505,505,505,505,505,505,505,505,505,505,505,505,505,505,505,505,505,505,505
496,496,496,496,496,496,496,496,496,496,496,496,496,496,496,496,496,496,465,542,505,505,505,505,505,505,505,505,505,505,505,505,630,505,505,505,505,505,505,505,505,505,505,505,505,632,505,505,505,505,505,505,505,505,505,505,505,631,632,505,505,505,505,505,586,505,505,505,505,505,505,505,505,505,505,505,505,505,505,505
496,496,496,496,496,496,496,496,635,633,635,496,496,496,496,496,465,541,542,505,505,632,505,505,505,505,505,505,505,631,505,505,505,505,505,505,505,505,505,505,505,505,505,505,505,585,505,505,505,505,505,505,505,505,505,505,505,505,505,632,505,505,505,505,631,505,505,505,505,505,505,505,505,505,505,505,505,505,505,505
496,496,496,496,496,496,496,496,496,496,496,496,496,496,496,465,542,505,505,505,585,505,505,505,505,505,505,505,505,505,505,505,631,505,505,505,505,505,505,505,505,505,586,631,505,505,505,505,505,505,505,505,505,585,505,505,505,505,505,505,505,505,505,505,505,505,505,505,505,505,505,505,505,505,505,505,505,505,505,505
496,496,496,496,496,496,496,496,496,496,496,496,496,496,465,542,505,505,505,505,505,585,631,505,505,505,505,587,505,505,505,505,587,505,505,505,505,505,505,585,505,505,505,505,505,505,505,632,505,505,505,505,505,505,505,505,630,505,505,505,505,630,505,505,505,505,505,505,505,505,505,505,505,505,505,505,505,505,505,505
635,588,496,496,496,496,496,496,496,496,496,496,496,496,497,505,505,505,505,505,505,505,505,505,505,505,505,505,505,505,505,505,505,505,505,505,505,505,505,505,505,505,505,505,505,505,505,505,505,505,505,505,505,505,505,505,587,505,505,505,505,631,505,505,505,505,505,505,505,505,505,505,505,505,505,505,505,505,505,505
496,496,496,496,496,496,496,496,496,496,496,496,496,496,497,505,505,505,505,632,505,505,505,505,505,505,505,505,505,505,505,505,505,505,505,505,505,505,505,505,505,505,505,505,505,505,505,505,505,505,505,505,505,585,586,585,505,505,505,505,505,505,505,505,505,505,505,505,505,505,505,505,505,505,505,505,505,505,505,505
496,633,496,496,496,496,496,496,496,496,496,496,496,496,497,505,505,586,505,505,587,630,505,505,586,586,630,505,505,505,505,505,505,505,505,505,630,505,505,505,505,505,505,505,505,505,585,505,505,505,505,505,505,631,505,505,505,505,505,505,505,505,505,505,505,505,505,505,505,505,505,505,505,505,505,505,505,505,505,505
496,633,496,496,496,496,496,496,496,588,588,496,496,496,497,505,505,505,505,505,505,505,505,505,587,585,505,505,505,587,505,505,505,630,505,505,505,505,505,505,505,585,505,505,505,505,505,505,505,505,587,505,505,505,505,505,505,505,505,505,505,505,505,505,505,505,505,505,505,505,505,505,505,505,505,505,505,505,505,505
496,496,496,496,496,496,496,496,496,496,496,634,590,496,510,452,505,505,505,585,631,505,505,505,505,505,505,505,505,505,505,505,505,505,505,505,505,505,505,505,505,505,505,505,505,505,505,505,505,505,505,505,505,505,505,505,505,505,505,505,505,505,505,505,505,505,505,505,505,505,505,505,505,505,505,505,505,505,505,505
466,496,496,496,496,496,496,496,496,496,496,496,496,496,496,497,505,505,505,505,505,505,505,505,505,505,505,505,505,505,505,505,505,505,505,586,505,586,505,505,505,505,505,505,505,505,505,505,505,632,505,505,505,505,505,505,505,505,505,505,505,505,505,505,505,505,505,505,505,505,505,505,505,505,505,505,505,505,505,505
495,496,496,496,496,496,496,496,496,496,496,496,496,496,589,497,505,505,630,505,505,505,505,505,505,505,505,505,505,505,505,585,505,505,505,505,505,505,505,505,505,505,505,505,586,505,630,505,505,505,505,505,505,505,505,505,505,505,505,505,505,505,505,505,505,505,505,505,505,505,505,505,505,505,505,505,505,505,505,505
495,496,496,496,496,496,496,496,496,496,496,496,496,496,588,497,505,505,505,505,505,505,505,505,505,505,505,632,586,505,505,505,505,632,505,505,631,505,505,505,505,505,505,505,505,505,505,505,505,505,505,505,505,505,505,505,505,505,505,505,505,505,505,505,505,505,505,505,505,505,505,505,505,505,505,505,505,505,505,505
511,496,496,496,496,496,496,496,496,496,589,496,496,496,590,497,505,505,505,505,505,505,587,505,505,505,505,505,505,505,505,505,505,505,505,505,505,505,505,505,630,631,505,505,505,505,505,505,505,505,505,505,505,505,505,505,505,505,505,505,505,505,505,505,505,505,505,505,505,505,505,505,505,505,505,505,505,505,505,505
496,496,496,496,496,496,496,496,496,496,496,496,496,496,465,542,505,505,505,505,505,505,505,505,505,505,505,505,505,585,505,505,505,586,505,505,505,505,505,505,505,505,505,505,505,505,505,505,505,505,505,505,505,505,505,505,505,505,505,505,505,505,505,505,505,505,505,505,505,505,505,505,505,505,505,505,505,505,505,505
496,496,496,496,496,496,496,496,496,496,496,496,496,496,497,505,505,505,631,630,505,505,505,505,505,505,505,505,505,505,505,505,505,505,505,505,505,505,505,505,505,505,505,505,505,505,505,505,505,505,505,505,505,505,505,505,505,505,505,505,505,505,505,505,505,505,505,505,505,505,505,505,505,505,505,505,505,505,505,505
496,496,496,496,496,496,496,496,496,496,496,496,635,496,497,505,505,505,505,505,505,631,505,631,505,505,505,505,505,505,505,505,505,505,505,505,505,587,587,505,505,505,505,505,505,505,505,505,505,505,505,505,505,505,505,505,505,505,505,505,505,505,505,505,505,505,505,505,505,505,505,505,505,505,505,505,505,505,505,505
496,496,496,496,496,496,496,496,496,496,496,496,496,496,497,505,505,505,505,505,505,505,505,505,505,505,505,505,505,505,586,505,505,505,505,505,505,505,505,505,505,505,505,505,505,505,505,505,505,505,505,505,505,505,505,505,505,505,505,505,505,505,505,505,505,505,505,505,505,505,505,505,505,505,505,505,505,505,505,505
496,496,496,496,496,496,496,496,496,496,496,496,496,496,497,505,505,586,505,505,505,505,505,505,630,505,505,505,505,505,505,505,630,505,505,505,505,505,505,505,505,505,505,505,505,505,505,505,505,505,505,505,505,505,505,505,505,505,505,505,505,505,505,505,505,505,505,505,505,505,505,505,505,505,505,505,505,505,505,505
496,496,496,496,496,496,496,496,496,496,496,496,496,496,497,505,505,505,505,505,505,631,505,505,505,505,505,505,505,505,505,505,505,505,505,505,505,505,505,505,505,505,505,505,505,505,505,505,505,505,505,505,505,505,505,505,505,505,505,505,505,505,505,505,505,505,505,505,505,505,505,505,505,505,505,505,505,505,505,505
496,496,496,496,496,496,496,496,496,496,496,588,496,496,497,505,505,505,505,630,505,505,505,505,505,505,505,505,505,505,505,505,505,505,505,505,505,505,505,505,505,505,505,505,505,505,505,505,505,505,505,505,505,505,505,505,505,505,505,505,505,505,505,505,505,505,505,505,505,505,505,505,505,505,505,505,505,505,505,505
541,466,496,496,496,496,496,496,496,496,496,496,496,496,497,505,505,630,505,505,505,585,505,630,505,505,587,505,505,505,505,505,505,505,505,505,505,505,505,505,505,505,505,505,505,505,505,505,505,505,505,505,505,505,505,505,505,505,505,505,505,505,505,505,505,505,505,505,505,505,505,505,505,505,505,505,505,505,505,505
505,540,466,496,496,496,496,496,496,496,496,496,496,465,542,505,630,505,505,505,505,505,505,505,505,505,505,505,505,505,505,505,505,505,505,505,505,505,505,505,505,505,505,505,505,505,505,505,505,505,505,505,505,505,505,505,505,505,505,505,505,505,505,505,505,505,505,505,505,505,505,505,505,505,505,505,505,505,505,505
587,505,540,466,496,496,496,496,496,496,496,496,496,497,505,505,505,505,505,505,505,505,505,505,505,505,505,505,505,505,505,505,505,505,505,505,505,505,505,505,505,505,505,505,505,505,505,505,505,505,505,505,505,505,505,505,505,505,505,505,505,505,505,505,505,505,505,505,505,505,505,505,505,505,505,505,505,505,505,505
505,505,505,495,496,496,496,496,496,496,588,496,465,542,505,505,587,505,505,505,505,505,505,505,505,505,505,505,505,505,505,505,505,505,505,505,505,505,505,505,505,505,505,505,505,505,505,505,505,505,505,505,505,505,505,505,505,505,505,505,505,505,505,505,505,505,505,505,505,505,505,505,505,505,505,505,505,505,505,505
505,505,632,495,496,496,496,496,496,589,496,465,542,505,505,505,505,505,505,505,505,631,505,505,505,505,505,505,505,505,505,505,505,505,505,505,505,505,505,505,505,505,505,505,505,505,505,505,505,505,505,505,505,505,505,505,505,505,505,505,505,505,505,505,505,505,505,505,505,505,505,505,505,505,505,505,505,505,505,505
505,505,505,495,496,496,496,496,496,634,496,497,505,505,631,505,505,505,505,505,505,505,505,505,505,505,505,505,505,505,505,505,505,505,505,505,505,505,505,505,505,505,505,505,505,505,505,505,505,505,505,505,505,505,505,505,505,505,505,505,505,505,505,505,505,505,505,505,505,505,505,505,505,505,505,505,505,505,505,505
505,586,505,540,466,496,496,496,496,496,496,497,505,505,505,505,505,631,505,505,505,505,505,505,505,505,505,505,505,505,505,505,505,505,505,505,505,505,505,505,505,505,505,505,505,505,505,505,505,505,505,505,505,505,505,505,505,505,505,505,505,505,505,505,505,505,505,505,505,505,505,505,505,505,505,505,505,505,505,505
505,505,630,505,495,496,496,496,496,496,465,542,505,505,505,505,505,505,505,505,505,632,505,505,505,505,505,505,505,505,505,505,505,505,505,505,505,505,505,505,505,505,505,505,505,505,505,505,505,505,505,505,505,505,505,505,505,505,505,505,505,505,505,505,505,505,505,505,505,505,505,505,505,505,505,505,505,505,505,505
505,505,505,505,495,496,496,496,635,496,497,505,505,505,505,505,505,505,505,505,505,505,505,505,505,505,505,505,505,505,505,505,505,505,505,505,505,505,505,505,505,505,505,505,505,505,505,505,505,505,505,505,505,505,505,505,505,505,505,505,505,505,505,505,505,505,505,505,505,505,505,505,505,505,505,505,505,505,505,505
505,505,505,505,495,496,633,588,496,465,542,505,632,505,505,505,505,505,505,505,505,505,505,505,505,505,505,505,505,505,505,505,505,505,505,505,505,505,505,505,505,505,505,505,505,505,505,505,505,505,505,505,505,505,505,505,505,505,505,505,505,505,505,505,505,505,505,505,505,505,505,505,505,505,505,505,505,505,505,505
505,505,505,632,540,466,496,496,465,542,505,505,586,505,505,505,505,632,505,505,505,505,505,505,505,505,505,505,505,505,505,505,505,505,505,505,505,505,505,505,505,505,505,505,505,505,505,505,505,505,505,505,505,505,505,505,505,505,505,505,505,505,505,505,505,505,505,505,505,505,505,505,505,505,505,505,505,505,505,505
505,505,505,505,505,495,496,496,497,505,505,505,505,505,505,505,505,505,505,505,505,505,505,505,505,505,505,505,505,505,505,505,505,505,505,505,505,505,505,505,505,505,505,505,505,505,505,505,505,505,505,505,505,505,505,505,505,505,505,505,505,505,505,505,505,505,505,505,505,505,505,505,505,505,505,505,505,505,505,505
505,505,505,585,505,495,496,496,497,505,505,505,505,505,631,505,505,505,505,505,505,505,505,505,505,505,505,505,505,505,505,505,505,505,505,505,505,505,505,505,505,505,505,505,505,505,505,505,505,505,505,505,505,505,505,505,505,505,505,505,505,505,505,505,505,505,505,505,505,505,505,505,505,505,505,505,505,505,505,505
505,505,505,505,505,495,496,496,497,505,505,505,505,505,505,505,505,505,505,505,505,505,505,505,505,505,505,505,505,505,505,505,505,505,505,505,505,505,505,505,505,505,505,505,505,505,505,505,505,505,505,505,505,505,505,505,505,505,505,505,505,505,505,505,505,505,505,505,505,505,505,505,505,505,505,505,505,505,505,505
505,505,505,505,585,540,541,541,542,505,505,505,505,505,505,505,632,505,505,505,505,505,505,505,505,505,505,505,505,505,505,505,505,505,505,505,505,505,505,505,505,505,505,505,505,505,505,505,505,505,505,505,505,505,505,505,505,505,505,505,505,505,505,505,505,505,505,505,505,505,505,505,505,505,505,505,505,505,505,505
505,505,505,505,505,505,505,505,505,585,505,505,505,505,630,505,505,505,505,505,505,505,505,505,505,505,505,505,505,505,505,505,505,505,505,505,505,505,505,505,505,505,505,505,505,505,505,505,505,505,505,505,505,505,505,505,505,505,505,505,505,505,505,505,505,505,505,505,505,505,505,505,505,505,505,505,505,505,505,505
452,505,505,505,505,505,505,585,505,505,505,587,505,505,505,585,505,505,505,505,505,505,505,505,505,505,505,505,505,505,505,505,505,505,505,505,505,505,505,505,505,505,505,505,505,505,505,505,505,505,505,505,505,505,505,505,505,505,505,505,505,505,505,505,505,505,505,505,505,505,505,505,505,505,505,505,505,505,505,505
510,452,505,505,505,505,505,505,505,505,505,505,505,505,505,505,450,451,451,452,505,505,505,505,505,505,505,505,505,505,505,505,505,505,505,505,505,505,505,505,505,505,505,505,505,505,505,505,505,505,505,505,505,505,505,505,505,505,505,505,505,505,505,505,505,505,505,505,505,505,505,505,505,505,505,505,505,505,505,505
496,497,505,505,505,505,505,586,505,505,505,505,505,505,505,505,495,496,496,497,505,505,505,505,505,505,505,505,505,505,505,505,505,505,505,505,505,505,505,505,505,505,505,505,505,505,505,505,505,505,505,505,505,505,505,505,505,505,505,505,505,505,505,505,505,505,505,505,505,505,505,505,505,505,505,505,505,505,505,505
496,497,505,505,505,632,505,505,505,505,505,630,505,505,505,450,511,496,496,510,452,505,505,505,505,505,505,505,505,505,505,505,505,505,505,505,505,505,505,505,505,505,505,505,505,505,505,505,505,505,505,505,505,505,505,505,505,505,505,505,505,505,505,505,505,505,505,505,505,505,505,505,505,505,505,505,505,505,505,505
496,510,452,505,505,505,505,505,505,505,505,630,505,505,505,495,496,496,496,496,497,505,505,505,505,505,505,505,505,505,505,505,505,505,505,505,505,505,505,505,505,505,505,505,505,505,505,505,505,505,505,505,505,505,505,505,505,505,505,505,505,505,505,505,505,505,505,505,505,505,505,505,505,505,505,505,505,505,505,505
635,496,497,505,505,505,505,505,505,505,505,505,587,505,505,540,466,496,496,496,510,451,452,505,505,505,505,505,505,505,505,505,505,505,505,505,505,505,505,505,505,505,505,505,505,505,505,505,505,505,505,505,505,505,505,505,505,505,505,505,505,505,505,505,505,505,505,505,505,505,505,505,505,505,505,505,505,505,505,505
