46,46,46,46,46,46,138,46,46,46,46,46,47,55,55,55,55,55,137,55,55,55,55,55,55,55,55,55,55,55,55,55,55,55,55,55,180,135,55,55,55,55,55,55,55,55,180,55,55,55,55,181,55,55,55,55,55,55,55,55,55,55,55,55,55,55,55,55,55,55,55,55,55,55,55,55,55,280,280,280
46,46,46,46,46,46,46,46,46,46,15,91,92,55,55,55,55,55,55,55,137,55,55,55,55,55,55,55,136,55,55,55,55,55,55,55,55,55,55,55,55,55,55,55,55,55,137,55,55,55,55,55,55,55,55,55,55,55,55,55,55,55,55,55,55,55,55,55,55,55,55,55,55,55,55,55,55,280,280,280
184,183,184,185,184,46,46,46,46,46,47,55,55,55,55,55,55,55,180,55,55,55,137,55,55,55,55,181,55,55,55,55,55,55,55,55,55,55,55,55,55,55,55,55,55,55,137,55,55,55,55,55,55,55,55,55,55,55,55,55,55,55,55,55,55,55,55,55,55,55,55,55,55,55,55,55,55,280,280,280
16,46,46,46,46,46,15,91,91,91,92,55,55,55,55,55,55,55,55,55,55,55,55,55,55,55,55,136,55,55,55,55,55,55,55,55,55,55,55,55,55,55,55,55,55,55,55,55,55,55,55,55,55,136,55,55,55,55,55,55,55,55,55,55,55,55,55,55,55,55,55,55,55,55,55,55,55,280,280,280
90,91,91,16,46,15,92,55,55,55,55,55,55,55,55,55,55,55,55,181,55,55,55,55,55,55,55,181,55,55,55,55,55,55,55,55,55,55,55,55,55,55,55,55,55,55,55,55,55,55,55,55,55,135,55,55,55,55,55,55,55,55,55,55,55,55,55,55,55,55,55,55,55,55,55,55,55,280,280,280
55,55,55,90,91,92,55,55,55,55,55,55,55,55,55,55,55,55,55,55,55,55,181,55,55,55,55,55,55,55,55,55,55,55,55,55,55,55,55,55,55,180,55,55,55,137,180,55,182,55,55,55,55,136,55,55,55,55,55,55,55,55,55,55,55,55,55,55,55,55,55,55,55,55,55,55,55,280,280,280
55,55,55,55,55,55,55,55,55,55,136,55,55,55,55,55,55,55,55,55,55,55,55,55,55,55,55,55,55,55,55,55,55,137,55,55,55,55,55,55,55,55,55,181,55,55,55,136,55,55,55,55,55,55,55,55,55,55,55,55,55,55,55,55,55,55,55,55,55,55,55,55,55,55,55,280,280,280,280,280
55,55,181,55,55,55,55,55,55,55,55,55,55,55,55,55,55,55,55,55,55,55,55,136,55,55,182,55,55,55,55,55,55,181,55,55,55,55,55,55,55,55,135,55,55,137,55,55,55,55,55,55,55,55,55,55,55,55,55,55,55,55,55,55,55,55,55,55,55,55,55,55,55,55,55,280,280,280,280,280
55,55,55,55,55,55,55,135,55,55,55,55,55,55,55,55,182,55,55,55,55,180,55,55,55,55,55,55,55,55,55,55,136,55,55,55,55,137,55,55,55,55,136,55,55,136,55,55,55,55,55,55,182,55,55,55,55,55,55,55,55,55,55,55,55,55,55,55,55,55,55,55,55,55,55,280,280,280,280,280
55,180,55,55,55,55,55,135,181,55,55,55,55,55,55,55,55,135,55,55,55,55,55,55,55,55,55,55,55,55,55,181,55,55,55,55,55,55,55,55,55,55,55,55,55,55,55,55,181,55,55,55,55,55,55,55,55,55,55,55,55,55,55,55,55,55,55,55,55,55,55,55,55,55,55,280,280,280,280,280
55,55,137,55,180,55,55,55,55,55,55,55,55,55,55,55,135,135,55,55,55,55,55,55,55,181,55,55,55,55,55,55,55,55,55,55,55,55,55,55,55,55,55,55,55,55,55,55,55,55,55,55,55,55,55,55,55,55,55,55,55,55,55,55,55,55,55,55,55,55,55,55,55,55,55,280,280,280,280,280
55,55,55,55,55,55,55,55,55,55,55,55,55,55,55,55,55,55,55,55,55,55,55,55,55,55,55,55,55,55,55,55,55,55,55,55,55,55,55,55,55,136,55,55,55,55,55,55,55,55,55,55,55,55,55,55,55,55,55,55,55,55,55,55,55,55,55,55,55,55,55,55,55,55,55,280,280,280,280,280
55,55,55,55,55,55,55,55,55,55,55,55,55,55,55,55,55,55,55,55,55,55,55,55,55,55,55,55,55,55,55,55,55,136,55,55,55,55,55,55,55,55,55,55,135,55,55,55,55,55,55,55,55,55,55,55,55,55,55,55,55,55,55,55,55,55,55,55,55,55,55,280,280,280,280,280,280,280,280,280
55,55,55,55,55,55,55,55,55,55,55,55,55,55,55,55,55,55,55,55,55,55,55,55,182,55,55,136,137,55,55,55,55,55,55,55,55,181,55,55,55,55,55,55,180,55,182,55,55,55,55,55,55,55,55,55,55,55,55,55,55,55,55,55,55,55,55,55,55,55,55,280,280,280,280,280,280,280,280,280
55,55,55,180,55,55,55,55,55,55,55,55,55,55,55,55,55,55,55,55,55,55,55,55,55,55,55,55,55,55,55,55,55,55,55,180,55,55,55,55,55,55,55,55,55,55,55,55,55,55,55,55,55,55,55,55,55,55,55,55,55,55,55,55,55,55,55,55,55,55,55,280,280,280,280,280,280,280,280,280
55,55,55,55,55,55,55,55,136,55,55,55,55,55,55,55,55,137,55,55,55,55,135,55,55,182,55,55,55,55,55,55,55,55,55,55,55,55,55,55,180,55,55,55,55,55,55,55,55,55,55,55,55,55,55,55,55,55,55,55,55,55,55,55,55,55,55,55,55,55,55,280,280,280,280,280,280,280,280,280
55,55,55,55,55,55,55,135,55,55,55,55,55,182,55,55,55,55,55,55,55,55,55,55,55,55,55,55,55,55,55,55,55,55,55,55,55,55,55,55,55,55,55,55,182,55,55,55,55,55,55,55,55,55,55,55,55,55,55,55,55,55,55,55,55,55,55,55,55,55,55,280,280,280,280,280,280,280,280,280
55,55,55,55,55,55,55,55,55,55,55,55,55,55,55,55,55,55,55,55,55,55,55,55,55,55,55,55,55,55,55,55,55,55,55,55,55,55,181,55,55,135,55,55,136,55,55,55,55,55,55,55,55,55,55,55,55,55,55,55,55,55,55,55,55,55,55,55,55,55,55,280,280,280,280,280,280,280,280,280
55,55,55,55,55,55,55,55,55,55,55,55,55,55,55,55,55,55,55,55,55,55,55,55,55,55,55,55,55,55,135,55,55,55,55,55,55,55,55,55,55,136,55,55,55,55,55,55,55,55,55,55,55,55,55,55,55,55,55,55,55,55,55,55,55,55,55,55,55,55,55,280,280,280,280,280,280,280,280,280
55,55,55,55,55,55,55,137,55,55,55,55,55,55,55,55,136,55,55,55,55,55,55,55,55,55,55,55,55,55,55,55,55,136,55,55,55,55,55,55,181,55,55,55,55,55,55,55,55,55,55,55,55,55,55,55,55,55,55,280,280,280,280,280,280,280,280,280,280,280,280,280,280,280,280,280,280,280,280,280
55,55,55,55,55,55,55,55,55,55,55,55,55,55,55,55,55,55,55,55,55,55,55,55,55,55,136,55,55,180,55,182,55,55,55,182,180,55,55,181,55,55,55,55,55,55,55,55,55,55,55,55,55,55,55,55,55,55,55,280,280,280,280,280,280,280,280,280,280,280,280,280,280,280,280,280,280,280,280,280
55,55,55,55,55,181,55,55,55,55,55,55,181,55,55,55,55,55,55,55,55,55,55,55,55,55,55,55,55,55,55,55,55,55,55,55,137,180,55,55,55,55,55,55,55,55,55,55,55,55,55,55,55,55,55,55,55,55,55,280,280,280,280,280,280,280,280,280,280,280,280,280,280,280,280,280,280,280,280,280
55,55,55,55,55,55,55,55,55,55,55,55,55,55,55,55,55,55,55,55,55,55,55,55,55,55,55,55,55,55,55,55,55,55,55,55,55,55,55,55,55,55,55,55,55,55,55,55,55,55,55,55,55,55,55,55,55,55,55,280,280,280,280,280,280,280,280,280,280,280,280,280,280,280,280,280,280,280,280,280
55,55,55,180,55,55,181,55,55,55,55,55,55,55,505,505,505,505,505,505,505,505,505,505,505,55,55,55,55,55,55,55,135,55,55,55,55,55,55,55,55,55,55,55,55,55,55,55,55,55,55,55,55,55,55,55,55,55,55,280,280,280,280,280,280,280,280,280,280,280,280,280,280,280,280,280,280,280,280,280
55,55,55,55,55,55,55,55,55,55,55,505,505,505,505,505,505,505,505,505,505,505,505,505,505,505,505,505,55,55,55,55,55,55,55,55,55,55,55,55,55,55,55,55,55,55,55,55,55,55,55,55,55,55,55,55,55,55,55,280,280,280,280,280,280,280,280,280,280,280,280,280,280,280,280,280,280,280,361,280
55,55,55,55,55,55,55,55,505,505,505,505,505,505,505,505,505,505,505,505,505,505,505,505,505,505,505,505,505,505,505,505,55,55,55,55,55,55,55,55,55,55,55,55,55,55,55,55,55,55,55,55,55,55,55,55,55,55,55,280,280,280,280,280,280,280,280,280,280,280,280,280,280,280,406,280,280,280,280,225
55,55,55,55,55,55,55,505,505,505,505,505,505,505,505,505,505,505,505,505,505,505,505,505,505,505,505,505,505,505,505,505,505,505,505,55,55,55,55,55,55,55,55,55,55,55,55,55,55,55,55,55,55,55,55,55,55,55,55,280,280,280,280,280,280,280,280,280,280,280,280,280,280,280,280,280,280,280,225,286
55,55,55,55,55,505,505,505,505,505,505,505,505,505,505,505,505,505,505,505,505,505,505,505,505,505,505,505,505,505,505,505,505,505,505,505,505,55,55,55,55,55,55,55,55,55,55,55,55,55,55,55,55,55,55,55,55,55,55,280,280,280,280,280,280,280,280,280,280,280,280,280,280,280,280,280,280,225,286,271
55,55,55,505,505,505,505,505,505,505,505,505,505,505,505,505,505,505,505,505,505,505,505,505,505,505,505,505,505,505,505,505,505,505,505,505,505,505,55,55,55,55,55,55,55,280,280,280,280,280,280,280,280,280,280,280,280,55,55,280,280,280,280,280,280,280,280,280,280,280,280,280,280,280,280,280,280,270,271,271
505,505,505,505,505,505,505,505,505,505,505,505,505,505,505,505,505,505,505,505,505,505,505,505,505,505,505,505,505,505,505,505,505,505,505,505,505,505,55,55,55,55,55,55,55,280,280,280,280,280,280,280,280,280,280,280,280,55,55,280,280,280,280,280,280,280,280,280,280,280,280,280,280,280,280,280,225,286,271,271
505,505,505,505,505,505,505,505,505,505,505,505,505,505,505,505,505,505,505,505,505,505,505,505,505,505,505,505,505,505,505,505,505,505,505,505,505,505,55,55,55,55,55,55,55,280,280,280,280,280,280,280,280,280,280,280,280,55,55,280,280,280,280,280,280,280,280,406,280,280,280,280,362,280,225,226,286,271,271,271
505,505,505,505,505,505,505,505,505,505,505,505,505,505,505,505,505,505,505,505,505,505,505,505,505,505,505,505,505,505,505,505,505,505,505,505,505,505,505,55,55,55,55,55,55,280,280,280,280,280,280,280,280,280,280,280,280,55,55,280,280,280,280,280,280,280,280,362,280,280,280,280,405,360,270,271,271,271,271,271
505,505,505,505,505,505,505,505,505,505,505,505,505,505,505,505,505,505,505,505,505,505,505,505,505,505,505,505,505,505,505,505,505,505,505,505,505,505,505,55,55,55,55,55,55,280,280,280,280,280,280,280,280,280,280,280,280,55,55,280,280,280,280,280,280,280,360,280,280,280,361,280,225,226,286,271,271,271,271,271
505,505,505,505,505,505,505,505,505,505,505,505,505,505,505,505,505,505,505,505,505,505,505,505,505,505,505,505,505,505,505,505,505,505,505,505,505,505,505,55,55,55,55,55,55,280,280,280,280,280,280,280,280,280,280,280,280,55,55,280,280,280,280,280,280,280,362,280,280,280,280,280,270,271,271,271,271,271,271,271
505,505,505,505,505,505,505,505,505,505,505,505,505,505,505,505,505,505,505,505,505,505,505,505,505,505,505,505,505,505,505,505,505,505,505,505,505,505,505,55,55,55,55,55,55,280,280,280,280,280,280,280,280,280,280,280,280,280,280,280,280,280,280,280,280,280,280,280,280,280,280,225,286,271,271,271,271,271,271,271
505,505,505,505,505,505,505,505,505,505,505,505,505,505,505,505,505,505,505,505,505,505,505,505,505,505,505,505,505,505,505,505,505,505,505,505,505,505,505,505,55,55,55,55,55,280,280,280,280,280,280,280,280,280,280,280,280,280,280,280,280,280,280,280,280,280,280,280,280,225,226,286,271,271,271,271,271,271,271,271
505,505,505,505,505,505,505,505,505,505,505,505,505,505,505,505,505,505,505,505,505,505,505,505,505,505,505,505,505,505,505,505,505,505,505,505,505,505,505,505,55,55,55,55,55,280,280,280,280,280,280,280,280,280,280,280,280,280,280,280,280,280,280,280,280,280,280,280,225,286,271,271,271,271,271,271,271,271,271,271
505,505,505,505,505,505,505,505,505,505,505,505,505,505,505,505,505,505,505,505,505,505,505,505,505,505,505,505,505,505,505,505,505,505,505,505,505,505,505,505,55,55,55,55,55,55,55,55,55,55,55,280,280,280,280,280,280,280,280,280,280,280,280,280,280,280,225,226,286,271,271,271,271,271,271,271,271,271,271,271
505,505,505,505,505,505,505,505,505,505,505,505,505,505,505,505,505,505,505,505,505,505,505,505,505,505,505,505,505,505,505,505,505,505,505,505,505,505,505,505,505,505,505,505,505,55,55,55,280,280,280,280,55,280,280,280,280,280,280,280,280,280,280,280,280,280,270,271,271,271,271,271,271,271,271,271,271,271,271,271
505,505,505,505,505,505,505,505,505,505,505,505,505,505,505,280,280,280,280,280,280,280,280,280,280,280,280,280,280,280,505,505,505,505,505,505,505,505,505,505,505,505,505,505,505,505,505,505,505,505,505,505,505,505,280,280,280,280,280,280,280,280,280,280,280,280,270,271,271,271,271,271,271,271,271,271,271,271,271,271
505,505,505,505,505,505,505,505,505,505,505,505,505,505,505,280,280,280,280,280,280,280,280,280,280,280,280,280,280,280,505,505,505,505,505,505,505,505,505,505,505,505,505,505,505,505,505,505,505,505,505,505,505,505,280,280,280,280,280,280,280,280,280,280,280,280,270,271,271,271,271,271,271,271,271,271,271,271,271,271
505,505,505,505,505,505,505,505,505,505,505,505,505,505,505,280,280,280,280,280,280,280,280,280,280,280,280,280,280,280,505,505,505,505,505,505,505,505,505,505,505,505,505,505,505,505,505,505,505,505,505,505,505,505,505,505,280,280,280,280,280,280,280,280,280,280,270,271,271,271,271,271,271,271,271,271,271,271,271,271
505,505,505,505,505,505,505,505,505,505,505,505,505,505,505,280,280,280,280,280,280,280,280,280,280,280,280,280,280,280,505,505,505,505,505,505,505,505,505,505,505,505,505,505,505,505,505,505,505,505,505,505,505,505,505,505,280,280,280,280,280,280,280,360,280,280,270,271,271,271,271,271,271,271,271,271,271,271,271,271
505,505,505,505,505,505,505,505,505,505,505,505,505,505,505,280,280,280,280,280,280,280,280,280,280,280,280,280,280,280,280,280,280,280,280,280,280,280,505,505,505,505,505,505,505,505,505,505,505,505,505,505,505,505,505,505,280,280,280,280,280,280,280,280,280,280,315,241,271,271,240,316,241,271,271,271,271,271,271,271
505,505,505,505,505,505,505,505,505,505,505,505,505,505,505,280,280,280,280,280,280,280,280,280,280,280,280,280,280,280,280,280,280,280,280,280,280,280,505,505,505,505,505,505,505,505,505,505,505,505,505,505,505,505,505,505,505,280,280,280,280,280,280,280,280,280,280,270,271,271,285,226,286,271,271,271,271,271,271,271
505,505,505,505,505,505,505,505,505,505,505,505,505,505,505,280,280,280,280,280,280,280,280,280,280,280,280,280,280,280,280,280,280,280,280,280,280,280,505,505,505,505,505,505,505,505,505,505,505,505,505,505,505,505,505,505,505,280,280,280,280,280,280,280,280,280,280,270,271,271,271,271,271,271,271,271,271,271,271,271
505,505,505,505,505,505,505,505,505,505,505,505,505,505,505,280,280,280,280,280,280,280,280,280,280,280,280,280,280,280,280,280,280,280,280,280,280,280,505,505,505,505,505,505,505,505,505,505,505,505,505,450,451,451,451,452,505,280,280,280,280,280,280,280,280,280,280,315,316,316,241,271,271,271,271,271,271,271,271,271
505,505,505,505,505,505,505,505,505,505,505,505,505,505,505,280,280,280,280,280,280,280,280,280,280,280,280,280,280,280,280,280,280,280,280,280,280,280,505,505,505,505,505,505,505,505,450,451,451,451,451,511,496,496,496,497,505,505,280,280,280,280,280,280,280,280,280,280,280,280,315,316,241,271,271,271,271,271,271,271
505,505,505,505,505,505,505,505,505,505,505,505,505,505,505,280,280,280,280,280,280,280,280,280,280,280,280,280,280,280,280,280,280,280,280,280,280,280,505,505,505,505,505,505,505,450,511,496,496,496,496,496,496,496,496,510,452,505,280,280,280,280,280,280,280,280,280,280,280,280,280,280,270,271,271,271,271,271,271,271
505,505,505,505,505,505,505,505,505,505,505,505,505,505,505,280,280,280,280,280,280,280,280,280,280,280,280,280,280,280,280,280,280,280,280,280,280,280,505,505,505,450,451,451,451,511,496,496,496,496,496,496,496,496,496,496,497,505,505,280,280,280,280,280,280,280,280,280,280,280,280,280,315,316,316,316,241,271,271,271
505,505,505,505,505,505,505,505,505,505,505,505,505,505,505,280,280,280,280,280,280,280,280,280,280,280,280,280,280,280,280,280,280,280,280,280,280,280,505,505,450,511,496,496,496,496,496,496,496,496,496,496,496,496,496,496,497,505,505,280,280,280,280,280,280,280,280,280,280,280,405,280,280,280,280,280,315,316,316,316
505,505,505,505,505,505,505,505,505,505,505,505,505,505,505,280,280,280,280,280,280,280,280,280,280,280,280,280,280,280,280,280,280,280,280,280,292,325,326,450,511,496,496,496,496,496,496,496,496,496,496,496,496,496,496,496,497,505,505,505,280,280,280,280,280,280,280,280,280,280,280,406,407,362,280,280,280,280,280,280
505,505,505,505,505,505,505,505,505,505,505,505,505,505,505,280,280,280,280,280,280,280,280,280,280,280,280,280,280,280,280,280,280,280,280,280,281,450,451,511,496,496,496,496,496,496,496,496,496,496,496,496,496,496,496,496,510,452,505,505,505,280,280,280,280,280,280,280,280,280,280,280,280,280,280,280,280,280,280,280
505,505,505,505,505,505,505,505,505,505,505,505,505,505,505,280,280,280,280,280,280,280,280,280,280,280,280,280,280,280,280,280,280,280,280,292,326,495,496,496,496,496,496,588,496,496,496,496,496,496,496,496,496,496,496,496,496,497,505,505,505,505,280,280,280,280,280,280,280,280,280,280,280,280,280,280,280,280,280,406
505,505,505,505,505,505,505,505,505,505,505,505,505,505,505,280,280,280,280,280,280,280,280,280,280,280,280,280,280,280,280,280,280,280,292,326,450,511,496,496,496,496,496,496,496,496,496,496,496,496,496,496,496,496,496,496,496,510,452,505,505,505,505,505,505,505,280,280,280,280,280,280,280,280,280,280,280,280,280,280
505,505,505,505,505,505,505,505,505,505,505,505,505,505,505,280,280,280,280,280,280,280,280,280,280,280,280,280,280,280,280,280,280,292,326,450,511,496,496,496,496,496,496,496,496,496,496,496,496,496,496,496,496,496,496,496,496,496,510,452,505,505,505,505,505,505,505,505,505,280,280,280,280,280,280,280,280,280,280,280
505,505,505,505,505,505,505,505,505,505,505,505,505,505,505,280,280,280,280,280,280,280,280,280,280,280,280,280,280,292,325,325,325,326,450,511,496,496,496,590,496,496,496,496,496,496,496,496,496,496,496,496,496,496,496,496,496,496,496,510,451,451,451,451,452,505,505,505,505,505,505,505,505,505,280,280,280,280,280,280
505,505,505,505,505,505,505,505,505,505,505,505,505,505,505,280,280,280,280,280,280,280,280,280,280,280,292,325,325,326,450,451,451,451,511,496,496,496,496,496,496,496,496,496,496,496,496,496,496,496,496,496,496,496,496,496,496,496,496,496,496,496,496,496,510,451,451,451,451,451,451,451,452,505,505,505,505,505,505,505
505,505,505,505,505,505,505,505,505,505,505,505,505,505,505,280,280,280,280,280,280,280,280,280,280,292,326,450,451,451,511,496,496,496,496,496,496,496,496,496,496,496,496,496,496,496,496,496,496,496,496,496,496,496,496,496,496,496,496,496,496,496,496,496,496,496,496,496,496,496,496,496,510,451,451,451,451,451,452,505
505,505,505,505,505,505,505,505,505,505,505,505,505,505,505,505,505,505,505,505,505,505,505,505,505,326,450,511,496,496,496,496,496,496,634,496,496,496,496,496,496,496,496,496,496,496,496,496,496,496,496,496,496,496,496,496,496,496,496,496,496,496,496,496,496,496,496,496,496,496,496,496,496,496,496,496,496,496,510,451
505,505,505,505,505,505,505,505,505,505,505,505,505,505,505,505,505,505,505,505,505,505,505,505,505,450,511,496,496,496,496,496,496,496,589,496,496,496,496,496,496,496,496,496,496,496,496,496,496,496,496,496,496,496,496,496,496,496,496,496,496,496,496,496,496,496,496,496,496,496,496,496,496,496,496,496,496,496,496,496
505,505,505,505,505,505,505,505,505,505,505,505,505,505,505,505,505,505,505,505,505,505,505,505,505,495,496,496,496,496,496,496,496,496,496,496,496,496,496,496,496,496,496,496,496,496,496,496,496,496,496,496,496,496,496,496,496,496,496,496,496,496,496,496,496,496,496,496,496,496,496,496,496,496,496,496,496,496,496,496
505,505,505,505,505,505,505,505,505,505,505,505,505,505,505,505,505,505,505,505,505,505,505,505,505,495,496,496,496,496,496,496,496,496,496,496,496,496,496,496,496,496,496,496,496,496,496,496,496,496,496,496,496,496,496,496,496,496,496,496,496,496,496,496,496,496,496,496,496,496,496,496,496,496,496,496,496,496,496,496
450,451,451,451,452,505,505,505,505,505,505,505,505,505,505,505,505,505,505,505,505,505,505,505,450,511,633,634,588,496,496,496,496,496,496,496,496,496,496,496,496,496,496,496,496,496,496,496,496,496,496,496,496,496,496,496,496,496,496,496,496,496,496,496,496,496,496,496,496,496,496,496,496,496,496,496,496,496,496,496
511,496,496,496,497,505,505,505,505,505,505,505,505,505,505,505,505,505,505,505,505,450,451,451,511,496,496,588,496,496,496,496,496,496,496,496,496,496,496,496,496,496,496,496,496,496,496,496,496,496,496,496,496,496,496,496,496,496,496,496,496,496,496,496,496,496,496,496,496,496,496,496,496,496,496,496,496,496,496,496
496,496,496,496,510,451,451,451,451,451,451,451,451,451,451,451,451,451,451,451,451,511,496,496,496,496,496,496,496,496,496,496,496,496,496,496,496,496,496,496,496,496,496,496,496,496,496,496,496,496,496,496,496,496,496,496,496,496,496,496,496,496,496,635,590,496,496,590,588,635,635,635,496,496,634,588,635,634,496,496
466,496,496,496,496,496,496,496,496,496,496,496,496,496,496,496,496,496,496,496,496,496,496,496,496,496,496,496,496,496,496,496,496,496,496,496,496,496,496,496,496,496,496,496,496,496,496,496,496,496,496,496,496,496,496,496,496,496,496,496,496,590,590,635,496,496,496,496,496,496,496,496,496,496,496,496,465,541,541,541
511,496,496,496,496,496,496,590,496,496,496,496,496,496,496,496,496,496,496,496,496,496,496,496,496,496,496,496,496,496,496,496,496,496,496,496,496,496,496,496,496,496,496,496,496,496,496,496,496,496,496,496,496,496,496,496,496,588,496,496,496,496,496,496,496,465,541,541,541,541,541,541,541,541,541,541,542,505,505,505
496,496,496,496,496,496,496,496,496,496,496,496,496,496,633,496,496,496,496,589,496,496,496,496,496,496,496,496,496,496,496,496,496,496,496,496,496,496,496,496,496,496,496,496,496,496,496,496,589,590,496,496,496,496,496,496,590,496,496,496,496,496,465,541,541,542,505,505,505,505,505,505,505,505,505,505,505,505,505,505
496,496,496,496,590,590,496,496,496,496,496,496,496,496,496,496,496,496,496,633,496,496,496,496,496,496,496,496,496,496,496,496,496,496,496,496,496,496,496,496,496,496,496,496,496,496,633,496,496,496,496,590,635,496,588,496,496,496,496,465,541,541,542,505,505,505,505,505,505,505,505,505,505,505,505,505,505,505,505,505
496,496,496,496,496,634,496,496,496,496,496,496,496,496,496,496,496,496,496,588,496,496,496,496,496,496,496,496,496,496,496,496,496,496,496,496,496,496,496,496,496,496,496,496,496,496,496,496,496,496,496,496,496,496,496,496,496,496,465,542,505,505,505,505,505,505,505,505,505,505,505,505,505,505,505,505,505,505,505,505
496,496,496,588,633,588,589,635,496,496,496,496,590,496,496,590,496,496,496,496,496,496,496,496,496,496,496,496,496,496,496,496,496,496,496,496,496,496,496,496,496,496,496,496,633,496,496,465,541,541,541,541,541,541,541,541,541,541,542,505,505,505,505,505,505,505,505,505,505,505,505,505,505,505,505,505,505,505,505,505
496,496,496,496,496,496,589,496,496,496,496,635,589,496,590,496,496,496,633,496,496,496,496,496,496,496,496,496,496,496,496,496,496,496,496,496,496,496,588,590,496,635,496,496,496,496,465,542,505,505,505,505,505,505,505,505,505,505,505,505,505,505,505,505,505,505,505,505,505,631,505,505,505,505,505,505,505,505,505,505
496,496,496,496,496,496,496,496,589,496,496,496,496,496,496,633,589,634,496,496,496,496,496,496,496,496,496,496,496,496,496,496,496,496,496,496,590,588,496,496,496,496,496,496,496,496,497,505,505,505,505,505,505,587,505,505,505,505,505,505,505,505,505,505,505,505,505,505,505,505,505,505,505,505,505,505,505,505,505,505
496,496,496,496,496,496,496,588,590,634,496,496,496,496,496,635,496,496,496,496,496,496,496,496,496,496,496,496,496,496,633,633,590,496,496,496,496,496,496,496,496,496,496,496,465,541,542,505,505,585,505,505,505,505,505,505,505,505,505,505,505,505,505,505,505,505,505,505,505,505,505,505,505,505,505,505,631,505,505,505
496,496,496,496,496,496,496,496,496,496,496,496,496,496,496,496,496,496,496,496,496,496,496,496,496,496,496,496,496,496,496,496,633,496,496,496,496,496,496,465,541,541,541,541,542,505,505,505,505,505,505,505,505,631,505,505,505,630,505,505,505,505,586,505,505,505,505,505,505,505,505,505,505,505,505,505,505,505,505,505
496,496,496,496,496,496,496,496,496,496,496,496,633,496,496,496,496,496,496,496,496,635,589,588,589,496,635,635,634,588,635,589,496,496,496,496,465,541,541,542,505,505,505,505,505,505,505,505,505,505,505,505,505,505,505,505,505,505,586,505,630,505,505,505,505,505,505,631,505,505,585,631,505,505,505,505,505,505,505,505
496,496,496,496,496,496,496,496,496,496,496,496,496,588,496,496,496,634,496,496,496,496,496,496,496,496,496,496,496,588,633,496,496,496,635,465,542,505,505,505,505,505,505,505,505,505,505,505,505,505,505,505,505,505,505,505,505,505,505,505,505,505,505,505,505,505,505,631,505,632,587,586,505,505,505,505,505,505,505,505
541,541,541,541,466,496,496,496,496,496,496,496,496,496,635,496,496,588,496,496,496,496,496,496,496,496,496,496,496,496,496,496,496,496,465,542,505,505,505,505,505,505,505,505,505,505,505,505,505,505,505,505,505,505,505,505,505,505,505,505,505,586,505,505,505,505,505,505,505,505,505,505,505,505,505,505,505,505,505,505
505,505,505,505,540,541,541,466,496,496,496,496,496,496,496,496,496,496,496,496,496,496,496,496,496,496,496,496,496,496,496,496,496,465,542,505,505,505,505,505,505,632,505,505,505,505,505,505,505,505,585,505,505,505,505,505,587,505,632,586,505,505,505,505,505,505,505,505,505,505,505,505,505,505,505,505,505,505,505,505
