46,46,46,46,46,46,46,46,46,46,46,46,46,46,46,46,46,46,46,46,46,46,46,46,46,46,46,46,46,46,46,46,46,46,46,46,46,46,46,46,46,46,60,2,55,55,55,55,55,55,137,55,55,55,55,181,55,55,55,55,55,55,55,55,55,137,55,55,55,55,55,55,55,55,55,55,55,180,55,55
46,46,46,46,46,46,46,46,46,46,46,46,46,46,46,46,46,46,46,46,46,46,46,15,16,46,46,46,46,46,46,46,46,46,46,46,46,46,46,46,46,46,46,60,1,1,1,1,2,55,55,55,55,55,55,55,55,55,55,55,55,55,55,55,55,55,55,55,55,55,55,55,55,55,55,55,55,135,55,55
46,46,46,46,46,46,46,46,46,46,46,46,46,46,46,138,46,46,46,46,46,46,46,60,61,46,46,46,46,46,46,46,46,46,46,46,46,46,46,46,139,46,46,46,46,46,46,46,60,2,55,55,55,55,55,55,137,55,55,55,55,55,55,55,55,55,55,55,180,181,55,55,55,55,55,55,55,182,180,55
46,46,46,46,46,46,46,46,46,46,46,46,46,46,46,46,46,46,46,46,46,46,46,46,46,46,46,46,46,46,46,46,46,46,46,46,46,46,46,46,46,46,183,183,46,46,46,46,46,60,2,55,55,180,55,55,55,55,55,55,55,55,55,55,55,55,55,137,55,182,55,55,55,55,55,55,55,55,55,55
46,46,46,46,46,46,46,46,46,46,46,46,46,46,46,46,46,46,46,46,46,46,46,46,46,46,46,46,46,46,46,46,46,46,46,46,46,46,46,46,46,46,46,46,140,139,139,46,46,46,60,1,2,55,55,55,55,55,55,55,182,55,55,55,55,55,55,55,55,55,55,55,55,55,55,55,55,55,55,135
46,46,46,46,46,46,46,46,46,46,46,46,46,46,46,46,46,46,46,46,46,46,46,46,46,46,46,46,46,46,46,46,46,46,46,46,46,46,46,46,46,46,46,46,46,46,185,46,46,46,46,46,60,1,1,1,1,1,2,55,55,55,55,55,55,55,55,55,182,55,55,55,55,55,55,55,55,55,181,55
46,46,46,46,46,46,46,46,46,46,46,46,46,46,46,46,46,46,46,46,46,46,46,46,46,46,46,46,46,46,46,46,46,46,46,46,46,46,46,46,46,46,46,46,46,46,46,46,138,138,46,46,46,46,46,46,46,46,60,2,55,55,55,55,55,55,55,55,55,55,55,55,55,55,55,55,55,182,55,55
46,46,46,46,46,46,46,46,46,46,46,46,46,46,46,46,46,46,46,46,46,46,46,46,46,46,46,46,46,46,46,46,46,46,46,46,46,46,46,46,46,46,46,46,46,46,46,46,46,46,184,46,15,91,16,46,46,46,46,60,1,2,55,55,55,55,55,55,180,55,55,55,55,55,55,55,137,55,55,55
46,46,46,46,46,46,46,46,46,46,46,46,46,46,46,46,46,46,46,46,46,46,46,46,46,46,46,46,46,46,46,46,46,46,46,46,46,46,46,46,46,46,46,46,46,46,46,46,46,46,46,46,60,1,61,46,46,46,46,46,46,47,55,55,55,55,55,55,55,55,55,55,55,55,55,55,55,55,55,55
46,46,46,46,46,46,46,46,46,46,46,46,46,46,46,46,46,46,46,46,46,46,46,46,46,46,46,46,46,46,46,46,46,46,46,46,46,46,46,46,46,46,46,46,46,46,46,46,46,46,46,46,46,46,46,46,46,46,46,46,46,60,1,2,55,55,55,55,55,55,55,55,55,55,55,55,55,55,55,55
46,46,46,46,46,46,46,46,46,46,46,46,46,46,46,46,46,46,46,46,46,46,46,46,46,46,46,46,46,46,46,46,46,46,46,46,46,46,46,46,46,46,46,46,46,46,46,46,46,46,46,46,46,46,46,46,46,46,46,46,46,46,46,60,2,55,55,55,55,180,55,55,55,55,55,55,55,55,55,55
46,46,46,46,46,46,46,46,46,46,46,46,46,46,46,46,46,46,46,46,46,46,46,46,46,46,46,46,46,185,46,46,46,46,46,46,46,46,46,139,46,46,46,46,46,46,46,46,46,46,46,46,46,46,46,46,46,46,46,46,46,46,46,46,60,2,55,55,55,55,55,55,55,55,55,55,55,55,55,55
46,46,46,46,46,46,46,46,46,46,46,46,46,46,46,46,46,46,46,46,46,46,46,46,46,46,46,46,46,183,46,46,46,46,46,46,46,46,46,46,138,46,46,46,46,46,46,46,46,46,46,46,46,46,46,46,46,46,46,46,46,46,46,46,46,60,1,2,55,55,55,55,55,55,55,55,136,55,55,55
46,46,46,46,46,46,46,46,46,46,46,46,46,46,46,46,46,46,46,46,46,46,46,46,46,46,46,46,46,184,46,46,46,46,46,46,46,46,46,46,185,46,46,46,46,46,46,46,46,46,46,46,46,46,138,46,46,46,46,46,46,46,46,46,46,46,46,47,55,55,55,55,55,55,55,55,55,55,55,55
46,46,46,46,46,46,46,46,46,46,46,46,46,46,46,46,46,46,46,46,46,46,46,46,46,46,46,46,46,46,140,46,46,183,46,46,46,46,46,15,16,46,46,46,46,46,46,46,46,46,46,46,46,46,184,46,46,46,46,46,46,139,46,46,46,46,46,47,55,55,55,55,55,55,55,55,55,55,55,55
46,46,46,46,46,46,46,46,46,46,46,46,46,46,46,46,46,46,46,46,46,46,46,46,46,46,46,46,46,46,46,46,46,46,46,46,46,46,46,60,61,138,46,46,46,46,46,46,46,46,46,46,46,46,183,46,46,46,46,46,46,46,46,46,46,46,46,47,55,55,55,55,55,55,55,181,55,55,55,55
46,46,46,46,46,46,46,46,46,46,46,46,46,46,46,15,16,46,46,46,46,46,46,46,46,46,46,46,46,15,16,46,46,46,184,46,15,91,16,46,46,46,46,46,46,46,46,46,46,46,46,46,46,185,46,46,46,46,46,46,46,46,46,46,46,46,46,47,55,55,55,55,55,55,55,55,55,55,55,55
46,46,46,46,46,46,46,46,46,46,46,46,46,46,46,60,61,46,46,46,46,46,46,140,139,140,46,46,15,92,90,91,91,91,91,91,92,55,90,16,46,46,46,46,46,46,46,46,46,46,46,46,46,46,46,46,15,16,46,46,46,46,46,46,46,46,46,47,55,55,55,55,55,55,55,55,55,55,55,55
46,46,46,46,46,46,46,46,46,46,46,46,46,46,46,46,46,46,46,46,46,46,46,140,46,46,46,15,92,55,55,55,55,55,55,55,55,55,55,90,16,46,46,46,46,46,46,46,46,46,46,46,46,46,46,46,60,61,46,46,46,46,46,46,46,46,46,47,55,55,55,180,55,55,55,55,55,55,55,55
46,46,46,46,46,46,46,46,46,46,46,46,46,46,46,46,46,46,46,46,46,46,46,15,16,46,46,47,55,55,55,55,137,55,55,55,55,55,55,55,90,16,46,183,184,46,46,46,46,46,46,46,46,46,46,46,46,46,46,46,46,46,46,46,46,46,46,47,55,55,55,55,55,55,55,55,55,55,55,55
46,46,46,46,46,46,46,46,46,46,46,46,46,46,46,46,46,46,46,46,46,46,46,60,61,46,15,92,55,55,55,55,55,55,55,55,55,55,55,55,55,90,91,16,183,139,46,46,46,46,46,46,46,46,46,46,46,46,46,46,46,46,46,46,46,46,46,60,2,55,55,55,55,137,55,55,55,55,55,55
46,46,46,46,46,46,46,46,46,46,46,46,46,46,46,46,46,46,46,46,138,46,46,15,91,91,92,55,55,55,55,137,55,55,181,55,55,55,55,55,55,55,55,45,184,138,46,46,46,46,46,46,46,46,46,46,46,46,46,46,46,46,46,46,46,46,46,46,47,55,55,55,55,181,55,55,55,55,55,55
46,46,46,46,46,46,46,46,46,46,46,46,46,46,46,46,46,46,46,46,185,183,15,92,55,55,55,55,55,55,55,55,55,55,55,55,55,55,55,55,135,55,0,61,46,140,46,46,46,46,46,46,46,46,46,46,46,46,46,46,46,46,46,140,46,46,46,46,47,55,55,55,55,55,55,55,55,55,55,55
46,46,46,46,46,46,46,46,46,46,46,46,46,46,46,46,46,46,46,46,140,185,47,55,55,55,55,55,135,55,55,55,55,55,55,55,55,55,55,55,55,55,45,46,46,46,140,46,46,46,46,46,46,46,46,46,46,46,46,46,46,46,46,46,46,46,46,46,47,55,55,55,55,55,55,55,55,55,55,55
46,46,46,46,46,46,46,46,46,46,46,46,46,46,46,46,46,46,46,184,185,140,47,55,55,55,55,55,55,55,55,55,55,55,55,182,55,55,55,55,55,55,45,46,46,46,46,46,46,46,46,183,46,46,46,46,46,46,46,46,46,46,46,46,46,46,46,46,47,55,55,55,55,55,55,55,55,55,55,55
46,46,46,46,46,46,46,46,46,46,46,46,184,139,140,140,185,15,91,16,46,15,92,55,182,55,55,55,55,55,55,55,55,55,55,55,55,135,55,55,55,55,45,46,46,183,183,46,46,46,46,185,183,46,46,46,46,46,46,46,46,46,46,46,46,185,140,46,47,55,55,55,55,55,55,55,55,55,55,55
46,46,46,46,46,46,46,46,46,46,46,46,46,46,46,46,46,60,1,61,46,47,55,55,55,55,55,55,55,55,55,55,55,136,55,55,55,55,55,55,55,55,45,46,46,184,184,46,46,46,46,140,185,46,46,46,46,46,46,46,46,46,46,46,46,46,46,15,92,55,180,55,55,55,55,137,55,55,55,55
46,46,46,46,46,46,46,46,46,46,46,46,46,46,46,46,46,140,46,46,15,92,55,55,55,55,182,55,55,55,55,55,55,55,55,55,55,55,55,55,55,55,45,140,46,46,46,46,46,46,46,46,46,46,46,46,46,46,46,46,46,46,46,46,46,15,91,92,55,55,55,55,55,55,55,55,55,55,55,55
46,46,46,46,46,46,46,46,46,46,46,46,46,46,46,46,46,139,15,91,92,55,55,55,55,55,55,55,55,55,55,55,55,55,55,55,55,55,55,55,55,0,61,46,46,46,46,46,46,46,46,46,46,46,46,46,46,46,46,46,46,46,46,46,46,47,55,55,55,55,55,55,55,55,55,55,55,55,55,55
46,46,46,46,46,46,46,46,46,46,46,46,46,46,46,46,15,91,92,55,55,55,55,55,55,180,55,55,55,55,55,55,180,180,55,55,55,55,55,55,55,45,46,46,46,138,46,46,46,46,46,46,46,46,46,46,46,46,46,46,46,46,15,16,46,47,55,55,55,180,55,55,55,55,55,137,55,55,55,55
46,46,46,46,46,46,46,46,46,46,46,46,46,46,46,15,92,55,55,55,55,55,137,55,55,55,55,55,55,55,55,55,55,55,55,55,181,55,55,55,0,61,46,46,46,46,46,46,46,46,46,46,46,46,46,46,46,46,46,46,46,46,47,45,46,47,137,55,55,55,55,55,55,55,55,55,55,55,55,55
46,46,46,46,46,46,46,46,46,46,46,183,15,16,46,47,55,55,55,55,55,55,55,55,55,55,55,180,55,55,55,55,55,55,55,55,55,55,55,0,61,46,46,46,46,46,46,46,46,46,46,46,46,46,46,46,46,46,46,46,15,91,92,45,15,92,55,55,55,55,55,55,55,55,55,55,55,55,55,55
46,46,46,46,46,46,46,46,46,46,46,46,47,45,46,47,55,55,55,55,55,55,55,55,55,55,181,55,55,55,55,55,55,55,55,55,55,55,55,45,46,138,46,46,46,46,46,46,46,46,46,46,46,46,46,46,46,46,46,46,60,1,1,61,47,55,55,136,55,55,55,55,55,55,55,55,55,55,181,55
46,46,46,46,46,46,46,46,46,15,16,46,47,45,46,47,55,55,55,55,55,55,55,55,55,55,55,55,55,55,136,55,55,55,55,55,55,55,55,45,46,46,46,46,46,46,46,46,46,46,46,46,46,46,46,46,46,46,46,46,46,46,46,46,47,55,55,55,55,55,55,55,55,55,55,55,55,55,55,55
46,46,46,46,46,46,46,15,16,60,61,46,60,61,15,92,55,55,55,55,55,55,55,55,55,55,55,180,55,55,55,55,55,55,55,55,55,0,1,61,46,46,46,46,46,46,46,46,46,46,46,46,46,46,46,46,46,46,46,46,46,46,46,15,92,55,55,55,55,55,55,180,182,55,55,55,55,55,55,55
46,46,46,46,46,46,46,60,61,46,46,46,15,91,92,55,55,55,55,55,55,55,55,55,55,55,55,55,55,136,55,55,55,55,55,55,0,61,46,46,46,46,46,46,46,46,46,46,46,46,46,46,46,46,46,46,46,46,46,46,46,46,46,47,55,55,55,55,55,181,55,55,55,55,55,55,55,55,55,55
46,46,46,46,46,46,46,46,46,46,46,15,92,55,182,55,55,55,55,55,55,55,55,55,55,55,55,55,55,55,55,55,55,55,55,0,61,46,46,46,46,46,46,46,46,46,46,46,46,46,46,46,46,46,46,46,46,46,46,46,46,46,46,47,182,55,55,137,55,55,55,55,55,55,55,55,55,55,55,55
46,46,46,46,46,46,46,46,46,46,46,47,55,55,55,55,55,55,55,55,55,55,137,55,55,55,55,55,55,55,55,55,55,55,0,61,46,46,46,46,183,46,46,46,46,46,46,46,46,46,46,46,46,46,46,46,46,46,46,46,140,138,46,47,55,55,55,55,55,55,55,55,136,55,55,55,55,136,55,55
46,46,46,46,46,46,46,46,46,184,46,47,55,55,55,137,55,55,55,55,55,55,55,55,55,55,55,55,55,55,55,55,55,55,45,46,46,185,46,46,46,46,46,46,46,46,46,46,46,46,46,46,46,46,46,46,46,46,46,46,46,46,46,60,2,55,55,55,55,55,181,55,55,55,55,55,55,55,137,55
46,46,46,46,46,46,46,46,46,140,46,47,55,55,137,55,55,55,55,55,55,135,55,55,55,55,55,55,55,55,55,55,55,55,45,46,46,46,46,46,46,46,46,46,46,46,46,46,46,46,46,46,46,46,46,46,46,46,46,46,46,46,46,46,47,55,55,55,55,55,55,55,55,135,55,55,55,55,55,55
46,46,46,46,46,46,46,46,138,46,46,47,55,55,55,182,55,55,55,55,55,55,55,55,55,55,55,55,55,55,55,55,55,55,45,46,46,46,46,46,46,46,46,46,46,46,46,46,46,46,46,46,46,46,46,46,46,46,46,46,46,46,46,46,47,55,55,55,55,55,55,55,55,55,55,55,55,55,55,55
46,46,46,46,46,46,139,138,138,46,46,47,55,55,55,137,55,55,55,55,55,55,55,55,55,55,55,55,55,55,55,55,55,55,90,16,46,46,46,46,46,46,46,46,46,46,46,46,46,46,46,46,46,46,46,46,46,46,46,46,46,46,46,46,47,55,55,55,55,55,55,55,55,55,136,55,55,55,55,55
46,46,46,46,46,46,46,46,46,46,46,47,55,55,55,55,55,55,55,55,55,55,55,55,55,55,55,55,136,55,55,55,55,55,55,45,46,138,46,46,46,46,46,46,46,46,46,46,46,46,46,46,46,46,46,46,46,46,46,46,46,46,46,46,47,55,55,55,55,55,55,55,55,180,55,55,55,55,55,55
46,46,46,46,46,184,46,46,46,184,46,47,55,55,55,55,55,55,55,55,55,55,55,55,55,55,55,55,55,55,55,55,55,55,55,45,139,140,184,138,46,46,46,46,46,46,46,46,46,46,46,46,46,46,46,46,46,46,46,46,46,46,46,46,47,55,55,55,55,55,55,55,55,182,182,55,55,55,55,55
46,46,46,46,46,46,184,46,46,183,46,47,55,55,55,55,55,55,135,55,55,55,180,55,55,55,55,55,55,182,55,55,55,55,0,61,46,46,46,138,46,46,46,46,46,46,46,46,46,46,46,46,46,46,46,46,46,46,46,140,46,15,16,46,47,55,181,55,55,55,55,55,181,55,182,55,55,55,55,55
46,46,46,46,46,46,139,46,46,46,15,92,55,55,55,55,55,55,55,55,55,55,55,55,55,55,55,55,55,55,55,55,55,55,45,46,46,46,46,139,46,46,46,46,46,46,46,46,46,46,46,46,46,46,46,46,138,46,46,46,46,47,45,46,47,55,55,55,55,181,55,55,55,55,55,55,55,55,55,55
46,46,46,46,46,46,46,46,46,46,47,55,55,55,55,55,137,55,55,55,55,55,55,55,55,55,55,55,55,55,55,55,55,0,61,46,184,184,46,46,46,46,46,46,46,46,46,46,46,46,46,46,46,46,46,46,46,46,46,46,46,60,61,15,92,55,55,55,55,55,55,55,55,55,55,55,55,55,55,55
46,46,46,46,46,46,46,46,46,46,60,2,55,55,55,55,55,55,55,55,55,55,55,55,55,55,55,181,55,55,55,55,0,61,46,46,140,46,46,46,46,46,46,46,46,46,46,46,46,46,46,46,46,46,46,46,46,46,46,46,46,46,15,92,55,55,135,135,55,55,55,55,55,55,55,55,55,55,55,55
46,46,184,46,46,46,46,15,16,46,46,47,55,55,55,55,55,55,55,55,55,55,55,55,55,55,55,55,55,55,55,0,61,15,91,91,16,46,46,46,46,46,46,46,46,46,46,46,46,46,46,46,46,46,46,46,46,46,46,46,46,15,92,55,55,55,55,180,55,55,55,55,137,137,55,55,55,55,55,55
46,46,46,46,46,46,46,47,90,16,46,47,55,55,55,55,55,55,55,55,55,55,55,55,55,55,55,55,55,55,0,61,46,60,1,1,61,46,46,46,46,46,46,46,46,46,46,46,46,46,46,46,46,46,46,46,46,46,183,46,46,47,55,55,55,55,55,55,55,55,55,55,55,55,55,55,55,55,55,55
46,46,46,46,46,46,15,92,55,45,46,47,55,55,55,55,55,55,55,55,55,55,55,55,55,55,55,55,55,55,45,185,46,46,46,46,139,46,46,46,46,46,46,46,46,46,46,46,46,46,46,46,46,46,138,184,46,46,139,46,46,47,55,181,136,55,55,55,55,55,55,135,55,55,55,55,55,55,55,55
46,46,46,46,46,15,92,55,55,45,46,47,55,55,55,55,55,55,55,55,55,55,55,55,55,180,135,55,55,0,61,46,46,46,46,46,139,184,46,46,46,46,46,46,46,46,46,46,46,46,46,46,46,46,46,46,46,46,140,46,46,47,55,55,55,55,55,55,55,55,55,55,135,55,55,55,55,55,55,55
46,46,46,46,46,47,55,55,55,45,46,47,55,55,180,55,55,55,55,55,55,55,55,55,55,55,55,137,55,45,46,46,46,46,46,183,46,140,46,46,46,46,46,46,46,46,46,46,46,46,46,46,46,46,46,46,46,46,46,46,46,47,55,55,55,55,55,55,55,55,55,55,55,55,55,55,55,55,55,55
46,46,46,46,46,47,55,55,0,61,46,47,55,55,55,55,55,55,55,55,55,55,55,55,55,55,55,55,55,45,46,46,46,185,46,46,46,139,46,46,46,46,46,46,46,46,46,46,46,46,46,46,46,46,46,46,46,15,91,16,46,47,55,55,55,180,55,55,55,55,55,55,55,55,55,55,55,55,55,55
46,185,46,46,15,92,55,0,61,46,15,92,55,55,55,55,55,55,55,55,55,55,55,55,55,55,55,55,55,45,46,185,185,139,46,46,46,46,46,46,46,46,46,46,46,46,46,46,46,46,46,46,185,184,46,46,46,60,1,61,15,92,55,55,55,55,55,55,55,55,55,55,55,55,55,55,55,55,55,55
46,183,15,91,92,55,0,61,46,46,47,55,55,55,55,55,55,55,55,55,55,55,55,55,55,55,55,55,55,45,184,15,16,184,46,46,46,46,46,46,46,46,46,46,46,46,46,46,46,46,46,46,46,46,46,46,46,46,46,15,92,55,55,181,55,135,180,55,55,55,55,55,55,55,55,55,55,55,55,55
46,15,92,55,55,55,45,46,46,15,92,55,55,55,55,181,55,55,55,55,55,55,55,55,55,55,55,55,55,45,46,60,61,46,46,46,46,46,46,46,46,46,46,46,46,46,46,46,46,140,46,46,46,46,46,46,46,15,91,92,55,55,55,55,55,55,55,55,55,55,55,55,55,55,55,55,55,55,55,55
46,47,55,55,55,55,45,46,15,92,55,55,55,55,55,180,55,55,55,55,55,180,55,55,55,55,137,55,55,90,16,46,46,183,140,46,184,185,46,46,46,46,46,46,46,46,46,46,46,46,46,46,46,46,46,46,15,92,55,55,55,55,180,55,55,55,55,55,55,55,55,55,55,55,55,55,55,55,55,55
91,92,55,55,55,55,45,46,47,55,55,55,55,55,55,135,55,55,55,55,55,55,55,55,55,55,135,55,55,55,45,46,46,46,46,46,46,46,46,46,46,46,46,46,46,46,46,46,46,46,46,46,46,46,46,15,92,55,55,55,55,55,182,136,55,181,55,55,55,55,55,55,55,55,55,55,55,55,55,55
55,55,55,55,55,55,45,46,47,55,55,55,55,55,55,55,55,55,55,55,55,55,55,55,55,55,55,137,137,55,45,46,46,46,46,46,46,46,46,46,46,46,46,46,46,46,46,46,46,139,46,46,46,46,15,92,55,55,55,55,55,55,55,137,55,55,55,55,55,55,55,55,55,55,55,55,55,55,55,55
135,55,55,55,55,0,61,46,47,55,55,55,55,55,55,137,136,55,55,55,55,55,55,55,55,55,55,55,55,55,45,46,46,46,46,46,46,46,46,46,46,46,46,46,46,46,46,46,46,46,46,46,46,15,92,55,55,55,55,55,55,55,55,55,55,55,55,55,55,55,55,55,55,55,55,55,55,55,55,55
55,55,137,55,55,45,46,46,47,55,55,55,55,55,55,55,55,55,55,55,55,55,55,55,55,55,55,55,55,0,61,46,46,46,46,46,46,46,46,46,46,46,46,46,46,46,46,46,46,46,46,46,15,92,55,55,55,55,55,55,55,55,55,55,55,55,55,55,55,55,55,55,55,55,55,55,55,55,55,55
2,55,55,55,55,45,46,15,92,55,55,55,55,55,55,55,55,55,55,55,55,55,55,55,55,55,55,55,0,61,46,46,46,46,46,46,46,46,46,46,46,46,46,46,46,46,46,46,46,46,15,91,92,55,55,55,55,55,55,55,135,55,55,55,55,55,55,55,55,55,55,55,55,55,55,55,55,55,55,55
47,55,180,55,55,45,46,47,55,55,55,55,55,55,181,55,55,55,55,55,55,55,55,55,55,55,55,0,61,46,138,140,46,46,46,46,46,46,46,46,46,46,46,46,46,46,46,46,15,91,92,55,55,55,55,55,55,135,55,55,55,55,55,55,55,136,55,55,55,55,55,55,55,55,55,55,55,55,55,55
92,55,55,55,55,45,46,47,55,55,55,55,55,55,55,55,55,55,55,55,55,182,55,55,55,55,55,45,46,46,184,46,46,46,46,46,46,46,46,46,46,46,46,46,46,46,46,15,92,55,55,55,55,55,55,55,55,55,55,55,55,55,55,55,55,180,55,55,55,55,55,55,55,55,55,55,55,55,55,55
55,55,55,55,55,45,46,60,2,55,136,55,182,55,55,55,55,55,55,55,55,55,55,55,55,55,0,61,46,46,46,46,46,46,46,46,46,46,46,46,46,46,46,15,16,46,15,92,55,55,55,55,55,55,55,55,55,55,55,55,55,182,55,55,55,55,55,55,55,55,55,55,55,55,55,55,55,55,55,55
55,55,55,55,55,45,46,46,47,55,55,55,55,55,55,55,55,182,181,55,55,55,55,55,55,0,61,46,46,183,138,184,46,46,46,46,46,46,46,46,46,15,16,60,61,15,92,55,55,55,55,182,55,55,182,55,55,136,135,55,55,55,55,55,55,55,55,55,55,55,55,55,55,55,55,55,55,55,55,55
55,55,137,55,55,45,46,46,47,55,55,55,55,55,55,55,55,55,55,55,55,55,55,55,55,45,46,46,46,46,46,46,185,46,46,46,46,46,46,15,16,60,61,46,15,92,55,55,55,55,55,136,55,55,55,55,55,180,136,55,55,55,55,55,55,55,55,55,55,55,55,55,55,55,55,55,55,55,55,55
55,55,55,55,55,45,46,46,47,55,55,136,55,55,55,55,55,55,55,55,55,55,55,55,55,45,46,46,46,46,46,46,46,46,46,46,46,15,16,60,61,46,46,15,92,55,55,55,55,55,55,55,55,55,55,55,135,55,55,55,55,55,55,55,55,55,55,135,55,55,55,55,55,55,55,55,55,55,55,55
1,2,55,55,0,61,46,46,47,55,55,55,55,135,55,55,55,55,55,55,55,55,55,55,55,45,46,46,46,46,46,46,46,46,46,46,46,47,45,46,15,91,91,92,55,135,55,55,55,55,55,55,55,55,55,181,180,55,55,55,55,55,55,55,55,55,55,55,55,55,55,55,55,55,55,55,55,55,55,55
46,47,55,55,45,46,46,46,47,55,55,55,136,180,55,55,55,55,55,137,137,55,55,55,55,45,46,46,46,184,138,46,46,46,46,46,46,60,61,15,92,55,55,55,55,55,55,55,55,55,55,55,55,55,55,55,55,182,55,55,55,182,55,55,55,55,55,55,55,55,55,55,55,55,55,55,55,55,55,55
46,47,55,0,61,46,46,46,47,55,55,55,180,55,55,55,180,55,55,55,55,55,55,55,55,90,91,16,46,184,46,46,46,138,138,140,184,184,15,92,55,55,55,55,55,55,55,182,55,55,55,55,55,55,55,55,55,55,55,55,55,55,55,55,55,55,55,55,55,55,55,55,55,55,55,55,55,55,55,55
46,60,1,61,185,46,46,46,60,2,55,55,136,55,55,55,182,55,55,55,55,55,55,55,55,55,55,45,46,46,46,46,46,181,185,139,15,91,92,55,55,55,55,55,55,55,135,55,55,55,55,55,55,55,55,55,55,55,55,55,55,55,55,55,55,55,55,55,55,55,55,55,55,55,55,55,55,55,55,55
46,46,46,139,46,46,46,46,46,47,55,55,55,55,55,55,55,55,55,137,55,55,55,55,55,55,55,45,46,46,46,46,46,15,91,91,92,55,55,55,55,55,55,55,55,55,180,55,55,55,55,55,55,55,55,55,55,55,55,55,55,55,55,55,55,55,135,55,55,55,55,55,55,55,55,55,55,55,55,55
46,46,46,140,185,184,139,46,46,47,55,180,55,55,55,55,55,55,55,55,55,55,55,55,55,55,55,90,91,91,91,91,91,92,55,55,55,55,55,55,135,55,55,55,55,55,136,55,55,55,55,55,55,55,55,55,55,55,55,55,55,55,55,135,55,55,55,55,55,55,55,55,55,55,55,55,55,55,55,55
46,46,46,46,46,46,46,46,46,60,2,55,55,55,55,55,55,136,55,55,55,55,55,55,55,55,55,55,55,55,55,55,55,55,55,55,55,55,55,55,55,55,55,55,55,55,180,55,55,55,55,55,55,55,55,182,55,55,55,55,55,55,55,55,55,55,135,55,55,55,55,55,55,55,55,55,55,55,55,55
46,46,46,46,46,46,46,46,46,46,60,2,55,55,55,55,55,182,55,55,180,55,55,182,181,55,55,55,55,55,55,55,55,55,55,55,55,55,55,55,55,55,55,55,55,55,181,55,55,55,55,55,55,55,55,55,55,55,55,55,55,55,55,55,55,136,55,55,55,55,55,55,55,55,55,55,55,280,280,280
16,46,46,46,46,46,46,46,183,184,46,60,2,55,55,55,55,55,55,55,55,55,55,55,136,55,55,55,55,181,55,55,55,55,55,55,55,55,55,135,55,55,55,55,55,55,135,55,55,55,180,55,136,55,55,55,55,55,55,55,55,55,55,55,137,55,55,55,55,55,55,55,55,55,55,55,55,280,280,280
61,46,46,46,46,46,46,46,46,46,46,46,47,55,55,55,55,55,55,55,55,55,55,135,55,55,55,55,55,135,55,55,55,55,55,55,55,55,55,55,135,136,55,55,55,55,181,55,55,55,55,55,55,180,55,55,55,181,55,55,55,55,55,55,55,55,55,55,55,55,55,55,55,55,55,55,55,280,280,280
46,46,46,46,46,46,139,46,46,46,46,46,47,55,55,55,55,55,55,181,55,55,55,55,55,55,55,55,55,55,55,55,180,55,55,55,55,55,55,55,55,55,55,55,55,55,136,55,55,55,55,55,55,55,55,55,55,55,137,135,137,55,55,55,55,55,55,55,55,55,55,55,55,55,55,55,55,280,280,280
