505,505,505,505,505,505,505,505,505,505,505,505,505,505,505,505,505,505,505,505,505,505,505,505,505,505,505,505,505,505,505,505,505,505,505,505,505,505,505,505,505,505,505,505,505,505,505,505,505,505,505,505,505,505,505,505,505,505,505,505,505,505,505,505,505,505,505,505,505,505,505,505,495,496,496,496,496,496,496,496
505,505,505,505,505,505,505,505,505,505,505,505,505,505,505,505,505,505,505,505,505,505,505,505,505,505,505,505,505,505,505,505,505,505,505,505,505,505,505,505,505,505,505,505,505,505,505,505,505,505,505,505,505,505,505,505,505,505,505,505,505,505,505,505,505,505,505,505,505,505,505,505,540,466,496,496,496,496,496,496
505,505,505,505,505,505,505,505,505,505,505,505,505,505,505,505,505,505,505,505,505,505,505,505,505,505,505,505,505,505,505,505,505,505,505,505,505,505,505,505,505,505,505,505,505,505,505,505,505,505,505,505,505,505,505,505,505,505,505,505,505,505,505,505,505,505,505,505,505,505,505,505,505,540,466,496,633,635,496,496
505,505,505,505,505,505,505,505,505,505,505,505,505,505,505,505,505,505,505,505,505,505,505,505,505,505,505,505,505,505,505,505,505,505,505,505,505,505,505,505,505,505,505,505,505,505,505,505,505,505,505,505,505,505,505,505,505,505,505,505,505,505,505,505,505,505,505,505,505,505,505,505,505,505,495,496,496,496,496,496
505,505,505,505,505,505,505,505,505,505,505,505,505,505,505,505,505,505,505,505,505,505,505,505,505,505,505,505,505,505,505,505,505,505,505,505,505,505,505,505,505,505,505,505,505,505,505,505,505,505,505,505,505,505,505,505,505,505,505,505,505,505,505,505,505,505,505,505,505,505,505,505,505,505,540,466,496,496,496,496
505,505,505,505,505,505,505,505,505,505,505,505,505,505,505,505,505,505,505,505,505,505,505,505,505,505,505,505,505,505,505,505,505,505,505,505,505,505,505,505,505,505,505,505,505,505,505,505,505,505,505,505,505,505,505,505,505,505,505,505,505,505,505,505,505,505,505,505,505,505,505,505,505,505,505,540,466,496,496,496
505,505,505,505,505,505,505,505,505,505,505,505,505,505,505,505,505,505,505,505,505,505,505,505,505,505,505,505,505,505,505,505,505,505,505,505,505,505,505,505,505,505,505,505,505,505,505,505,505,505,505,505,505,505,505,505,505,505,505,505,505,505,505,505,505,505,505,505,505,505,505,505,505,505,505,505,540,541,541,541
505,505,505,505,505,505,505,505,505,505,505,505,505,505,505,505,505,505,505,505,505,505,505,505,505,505,505,505,505,505,505,505,505,505,505,505,505,505,505,505,505,505,505,505,505,505,450,451,451,452,505,505,505,505,505,505,505,505,505,505,505,505,505,505,505,505,505,505,505,505,505,505,505,505,505,505,505,505,505,505
505,505,505,505,505,505,505,505,505,505,505,505,505,505,505,505,505,505,505,505,505,505,505,505,505,505,505,505,505,505,505,505,505,505,505,505,505,505,505,505,505,505,505,505,505,450,511,496,496,497,505,505,505,505,505,505,505,505,505,505,505,505,505,505,505,505,505,505,505,505,505,505,505,505,505,505,505,505,505,505
505,505,505,505,505,505,505,505,505,505,505,505,505,505,505,505,505,505,505,505,505,505,505,505,505,505,505,505,505,505,505,505,505,505,505,505,505,505,505,505,505,505,505,450,451,511,496,496,465,542,505,505,505,505,505,505,505,505,505,505,505,505,505,505,505,505,505,505,505,505,505,505,505,505,505,505,505,505,505,505
505,505,505,505,505,505,505,505,505,505,505,505,505,505,505,505,505,505,505,505,505,505,505,505,505,505,505,505,505,505,505,505,505,505,505,505,505,505,505,505,505,505,450,511,496,496,496,465,542,505,505,505,505,505,505,505,505,505,505,505,505,505,505,505,505,505,505,505,505,505,505,505,505,505,505,505,505,505,505,505
505,505,505,505,505,505,505,505,505,505,505,505,505,505,505,505,505,505,505,505,505,505,505,505,505,505,505,505,505,505,505,505,505,505,505,505,505,505,505,505,505,450,511,496,496,465,541,542,505,505,505,505,505,505,505,505,505,505,505,505,505,505,505,505,505,505,505,505,505,505,505,505,505,505,505,505,505,505,505,505
505,505,505,505,505,505,505,505,505,505,505,505,505,505,505,505,505,505,505,505,505,505,505,505,505,505,505,505,505,505,505,505,505,505,505,505,505,505,505,505,450,511,496,496,465,542,505,505,505,505,505,505,505,505,505,505,505,505,505,505,505,505,505,505,505,505,505,505,505,505,505,505,505,505,505,505,505,505,505,505
505,505,505,505,505,505,505,505,505,505,505,505,505,505,505,505,505,505,505,505,505,505,505,505,505,505,505,505,505,505,505,505,505,505,505,505,505,450,451,451,511,496,496,465,542,505,505,505,505,505,505,505,505,505,505,505,505,505,505,505,505,505,505,505,505,505,505,505,505,505,505,505,505,450,451,451,452,505,505,505
505,505,505,505,505,505,505,505,505,505,505,505,505,505,505,505,505,505,505,505,505,505,505,505,505,505,505,505,505,505,505,505,505,505,505,450,451,511,496,496,496,465,541,542,505,505,505,505,505,505,505,505,505,505,505,505,505,505,505,505,505,505,505,505,505,505,505,505,505,505,450,451,451,511,496,496,510,452,505,505
505,505,505,505,505,505,505,505,505,505,505,505,505,505,505,505,505,505,505,505,505,505,505,505,505,505,505,505,505,450,451,451,451,451,451,511,496,496,496,465,541,542,505,505,505,505,505,505,505,505,505,505,505,505,505,505,505,505,505,505,505,505,505,505,505,505,505,505,505,505,495,496,496,496,496,496,496,497,505,505
505,505,505,505,505,505,505,505,505,505,505,505,505,505,505,505,505,505,505,505,505,505,505,505,505,505,505,505,450,511,496,496,496,496,496,496,496,465,541,542,505,505,505,505,505,505,505,505,505,505,505,505,505,505,505,505,505,505,505,505,505,505,505,505,505,505,505,505,505,505,495,496,496,496,496,496,496,497,505,505
505,505,505,505,505,505,505,505,505,505,505,505,505,505,505,505,505,505,505,505,505,505,505,505,505,505,505,450,511,496,465,541,541,466,496,496,465,542,505,505,505,505,505,505,505,505,505,505,505,505,505,505,505,505,505,505,505,505,505,505,505,505,505,505,505,505,505,505,450,451,511,496,496,496,496,496,496,510,451,452
505,505,505,505,505,505,505,505,505,505,505,505,505,505,505,505,505,505,505,505,505,505,505,505,505,505,450,511,633,496,510,451,451,511,496,496,497,505,505,505,505,505,505,505,505,505,505,505,505,505,505,505,505,505,505,505,505,505,505,505,505,505,505,505,505,505,450,451,511,496,496,496,496,496,496,496,496,496,496,510
505,505,505,505,505,505,505,505,505,505,505,505,505,505,505,505,505,505,505,505,505,505,505,505,450,451,511,496,496,496,496,496,496,496,465,541,542,505,505,505,505,505,505,505,505,505,505,505,505,505,505,505,505,505,505,505,505,505,505,505,505,505,505,505,505,505,495,496,496,496,496,496,496,496,496,496,496,496,496,496
505,505,505,505,505,505,505,505,505,505,505,505,505,505,505,505,505,505,505,505,505,505,505,450,511,496,496,496,634,496,465,541,541,541,542,505,505,505,505,505,505,505,505,505,505,505,505,505,505,505,505,505,505,505,505,505,505,505,505,505,505,505,505,505,505,505,495,496,496,496,496,496,496,496,496,496,496,496,496,496
505,505,505,505,505,505,505,505,505,505,505,505,505,505,505,505,505,505,505,505,505,505,450,511,496,496,496,496,496,465,542,505,505,505,505,505,505,505,505,505,505,505,505,505,505,505,505,505,505,505,505,505,505,505,505,505,505,505,505,505,505,505,505,505,505,505,495,496,496,496,496,496,496,496,496,496,496,496,496,496
505,505,505,505,505,505,505,505,505,505,505,505,505,505,505,505,505,505,505,505,505,450,511,496,633,588,496,496,465,542,505,505,505,505,505,505,505,505,505,505,505,505,505,505,505,505,505,505,505,505,505,505,505,505,505,505,505,505,505,505,505,505,505,505,505,505,495,496,496,496,496,496,496,496,496,496,496,496,496,496
505,505,505,505,505,505,505,505,505,505,505,505,505,505,505,505,505,505,505,450,451,511,496,496,496,496,496,465,542,505,505,505,505,505,505,505,505,505,505,505,505,505,505,505,505,505,505,505,505,505,505,505,505,505,505,505,505,505,505,505,505,505,505,505,505,505,540,466,496,496,496,496,496,496,496,496,496,496,496,496
505,505,505,505,505,505,505,505,505,505,505,505,505,505,505,505,505,505,450,511,496,496,496,496,496,465,541,542,505,505,505,505,505,505,505,505,505,505,505,505,505,505,505,505,505,505,505,505,505,505,505,505,505,505,505,505,505,505,505,505,505,505,505,505,505,505,505,495,496,496,496,496,496,496,496,496,496,496,496,496
505,505,505,505,505,505,505,505,505,505,505,505,505,505,505,505,505,450,511,496,633,496,465,541,541,542,505,505,505,505,505,505,505,505,505,505,505,505,505,505,505,505,505,505,505,505,505,505,505,505,505,505,505,505,505,505,505,505,505,505,505,505,505,505,505,505,450,511,496,496,496,496,496,496,496,496,496,496,496,496
505,505,505,505,505,505,505,505,505,505,505,505,505,505,505,450,451,511,496,496,590,465,542,505,505,505,505,505,505,505,505,505,505,505,505,505,505,505,505,505,505,505,505,505,505,505,505,505,505,505,505,505,505,505,505,505,505,505,505,505,505,505,505,505,450,451,511,496,496,496,496,496,496,496,496,496,496,496,496,496
505,505,505,505,505,505,505,505,505,505,505,505,505,450,451,511,496,633,496,465,541,542,505,505,505,505,505,505,505,505,505,505,505,505,505,505,505,505,505,505,505,505,505,505,505,505,505,505,505,505,505,505,505,505,505,505,505,505,505,505,505,505,450,451,511,496,496,496,496,496,496,496,496,496,496,496,496,496,496,496
505,505,505,505,505,505,505,505,505,505,505,450,451,511,634,496,496,465,541,542,505,505,505,505,505,505,505,505,505,505,505,505,505,505,505,505,505,505,505,505,505,505,505,505,505,505,505,505,505,505,505,505,505,505,505,505,505,450,451,451,451,451,511,496,496,496,496,589,496,496,496,496,496,496,496,496,496,496,465,541
505,505,505,505,505,505,505,505,450,451,451,511,496,496,588,496,496,497,505,505,505,505,505,505,505,505,505,505,505,505,505,505,505,505,505,505,505,505,505,505,505,505,505,505,505,505,505,505,505,505,505,505,505,505,505,505,450,511,496,496,496,496,496,496,496,496,496,496,496,496,496,496,465,541,541,541,541,541,542,505
505,505,505,505,505,505,450,451,511,496,496,496,496,589,465,541,541,542,505,505,505,505,505,505,505,505,505,505,505,505,505,505,505,505,505,505,505,505,505,505,505,505,505,505,505,505,505,505,505,505,505,505,505,505,450,451,511,496,496,634,496,496,496,496,496,465,541,541,541,541,541,541,542,505,505,505,505,505,505,505
505,505,505,505,505,450,511,496,496,496,465,541,541,541,542,505,505,505,505,505,505,505,505,505,505,505,505,505,505,505,505,505,505,505,505,505,505,505,505,505,505,505,505,505,505,505,505,505,505,505,505,450,451,451,511,496,496,635,590,496,465,541,541,541,541,542,505,505,505,505,505,505,505,505,505,505,505,505,505,505
505,505,505,505,505,495,496,465,541,541,542,505,505,505,505,505,505,505,505,505,505,505,505,505,505,505,505,505,505,505,505,505,505,505,505,505,505,505,505,505,505,505,505,505,505,505,505,450,451,451,451,511,496,496,496,496,496,465,541,541,542,505,505,505,505,505,505,505,505,505,505,505,505,505,505,505,505,505,505,505
505,505,505,505,450,511,496,497,505,505,505,505,505,505,505,505,505,505,505,505,505,505,505,505,505,505,505,505,505,505,505,505,505,505,505,505,505,505,505,505,505,505,505,505,450,451,451,511,496,496,496,496,496,465,541,541,541,542,505,505,505,505,505,505,505,505,505,505,505,505,505,505,505,505,505,632,505,505,505,505
505,505,505,450,511,496,465,542,505,505,505,505,505,505,505,505,505,505,505,505,505,505,505,505,505,505,505,505,505,505,505,505,505,505,505,505,505,505,505,505,505,450,451,451,511,496,496,496,496,496,496,465,541,542,505,505,505,505,505,505,505,505,505,505,505,505,505,505,505,505,505,505,505,505,505,586,505,505,505,505
505,505,505,495,496,496,497,505,505,505,505,505,505,505,505,505,505,505,505,505,505,505,505,505,505,505,505,505,505,505,505,505,505,505,505,505,450,451,451,451,451,511,496,496,496,496,496,496,465,541,541,542,505,505,505,505,505,505,505,505,505,505,505,505,505,632,505,505,505,505,505,505,505,505,505,505,505,505,505,505
505,450,451,511,496,465,542,505,505,505,505,505,505,505,505,505,505,505,505,505,505,505,505,505,505,505,505,505,505,505,505,505,505,505,450,451,511,496,496,496,496,496,496,496,496,496,465,541,542,505,505,505,505,505,505,505,505,505,505,505,630,505,505,505,587,505,505,505,505,505,505,505,505,505,505,505,585,631,505,505
451,511,496,496,465,542,505,505,505,505,505,505,505,505,505,505,505,505,505,505,505,505,505,505,505,505,505,505,505,505,505,505,450,451,511,496,496,496,496,496,496,465,466,496,496,465,542,505,505,505,505,505,505,505,505,505,505,505,505,505,505,505,505,505,505,505,505,505,505,505,505,505,505,505,505,505,505,505,505,505
496,496,496,465,542,505,505,505,505,505,505,505,505,505,505,505,505,505,505,505,505,505,505,505,505,505,505,505,505,505,505,450,511,496,496,496,496,465,541,541,541,542,495,496,465,542,505,505,505,505,505,505,505,505,505,505,505,505,505,632,505,630,505,505,505,631,505,505,505,505,505,505,505,505,505,505,505,505,505,505
496,465,541,542,505,505,505,505,505,505,505,505,505,505,505,505,505,505,505,505,505,505,505,505,505,505,505,505,505,505,505,495,496,465,541,541,541,542,505,505,505,505,540,541,542,505,505,505,505,505,505,505,505,505,505,630,505,630,505,505,585,505,505,505,505,505,505,631,505,505,505,505,505,505,505,505,631,505,586,505
541,542,505,505,505,505,505,505,505,505,505,505,505,505,505,505,505,505,505,505,505,505,505,505,505,505,505,505,505,505,505,540,541,542,505,505,505,505,505,505,505,505,505,505,505,505,505,505,505,505,505,505,505,505,586,505,505,505,505,505,505,505,505,505,505,505,505,505,505,505,505,505,505,505,505,505,505,505,505,505
505,505,505,505,505,505,505,505,505,505,505,505,505,505,505,505,505,505,505,505,505,505,505,505,505,505,505,505,505,505,505,505,505,505,505,505,505,505,505,505,505,505,505,505,505,505,505,505,505,505,505,505,505,505,505,505,505,505,505,505,505,505,505,505,505,505,505,505,505,630,505,505,505,505,505,505,505,505,505,505
505,505,505,505,505,505,505,505,505,505,505,505,505,505,505,505,505,505,505,505,505,505,505,505,505,505,505,505,505,505,505,505,505,505,505,505,505,505,505,505,505,505,505,505,505,505,505,505,505,505,505,505,505,505,505,505,505,505,505,505,505,505,505,505,505,632,505,505,505,505,505,505,505,505,505,505,505,505,505,505
505,505,505,505,505,505,505,505,505,505,505,505,505,505,505,505,505,505,505,505,505,505,505,505,505,505,505,505,505,630,505,505,630,505,505,505,585,505,505,505,505,505,505,505,505,505,631,505,505,505,505,630,505,505,505,505,505,505,505,505,505,505,505,505,585,505,505,505,505,505,505,505,505,631,505,505,505,505,505,505
505,505,505,505,505,505,505,505,505,505,505,505,505,505,505,505,505,505,505,505,586,505,505,505,505,505,505,505,505,505,505,505,505,505,505,505,505,505,505,505,505,505,505,505,505,505,505,505,505,505,505,505,505,505,505,505,505,632,505,505,505,505,505,505,505,505,505,505,505,505,505,505,505,505,505,505,505,505,505,505
505,505,505,505,505,505,505,505,505,505,505,505,505,505,505,505,505,505,505,505,505,505,505,585,505,505,505,587,505,505,505,505,505,505,505,505,505,505,505,505,505,505,505,505,505,505,505,505,505,505,505,505,505,505,505,587,505,505,630,505,505,505,505,505,505,505,505,505,505,505,505,505,505,587,631,505,505,505,505,505
505,505,505,505,505,505,505,505,505,505,505,505,505,505,505,505,505,505,505,505,586,505,505,505,505,505,505,505,505,505,505,505,505,505,505,505,505,505,505,505,505,505,505,505,505,505,505,505,505,505,505,505,505,505,505,505,505,587,505,505,505,505,505,505,505,505,505,505,505,505,505,505,505,505,505,505,505,505,505,505
505,505,505,505,505,505,505,505,505,505,505,505,505,505,505,505,505,586,505,505,505,505,505,505,505,505,505,505,587,505,505,505,505,505,505,505,505,505,505,505,505,586,505,505,505,505,505,505,505,505,505,505,505,505,505,505,505,632,505,505,505,505,505,505,505,505,505,505,505,505,505,505,505,505,505,505,505,505,505,505
505,505,505,505,505,505,505,505,505,505,505,505,505,505,505,505,505,505,505,505,505,505,505,631,505,505,505,505,505,505,505,505,505,505,505,630,505,505,505,505,505,505,505,505,505,505,505,505,505,505,505,505,505,505,505,505,505,505,505,505,505,505,505,505,505,505,505,505,505,505,505,505,505,505,505,505,505,587,505,505
505,505,505,505,505,505,505,505,505,505,505,505,505,505,505,505,505,505,505,631,505,505,505,505,505,505,505,505,505,505,505,505,505,505,505,505,587,505,505,505,505,505,505,505,505,505,586,505,505,505,505,505,505,505,505,505,505,505,505,505,505,505,505,505,505,505,505,505,505,505,505,505,505,505,505,505,630,505,505,505
505,505,505,505,505,505,505,505,505,505,505,505,505,505,632,630,505,505,505,585,505,505,505,505,505,587,505,505,505,505,505,505,505,505,505,505,630,585,505,505,505,505,505,505,505,505,505,505,505,505,505,505,505,505,505,505,585,585,585,505,505,505,505,505,505,505,505,631,505,505,505,505,631,505,505,505,505,505,505,505
505,505,505,505,505,505,505,505,505,505,505,505,505,505,505,632,585,586,505,505,505,505,505,505,505,505,505,505,505,505,505,505,505,505,505,505,505,505,505,505,505,505,505,505,505,505,505,505,505,505,505,505,505,505,505,505,505,505,630,505,505,505,505,505,505,505,505,505,505,586,505,505,505,505,505,505,505,505,505,505
505,505,505,505,505,505,505,505,505,505,505,505,505,505,505,505,587,505,505,505,505,505,505,505,505,505,505,505,505,505,505,505,505,505,585,505,505,505,505,505,505,505,505,505,505,505,505,505,505,505,505,505,505,505,505,505,630,505,505,505,505,505,505,505,505,505,505,505,505,587,505,505,505,505,505,505,505,505,505,505
505,505,505,505,505,505,505,505,505,505,505,505,505,505,505,505,505,505,505,505,505,505,505,632,505,505,505,505,505,505,505,505,505,505,632,587,505,505,505,505,505,505,505,632,505,505,505,505,505,505,505,505,505,505,505,505,505,505,505,505,505,505,587,505,505,505,505,505,505,505,505,505,505,505,505,505,585,587,505,505
505,505,505,505,505,505,505,505,505,505,505,505,505,505,505,505,505,505,505,505,505,505,505,586,505,505,505,505,505,505,505,505,505,505,505,505,505,505,505,505,505,505,505,505,505,587,505,587,505,505,505,505,505,505,505,505,505,505,505,505,505,505,586,505,505,505,505,505,505,505,505,505,505,505,505,505,505,505,505,505
505,505,505,505,505,505,505,505,505,505,505,505,505,505,505,505,505,505,505,505,505,505,505,505,505,505,505,505,505,505,505,505,505,505,505,505,505,505,505,505,505,505,505,505,631,587,505,505,505,505,505,505,505,505,505,505,505,505,505,505,505,505,505,505,505,632,505,505,505,505,505,505,505,505,505,586,585,505,505,505
451,452,505,505,505,505,505,505,505,505,505,505,505,505,505,505,505,505,505,505,505,505,586,505,505,505,505,505,505,505,505,505,505,505,505,630,505,505,505,505,505,505,505,505,505,505,505,505,505,505,505,505,505,505,505,505,505,505,631,505,505,505,505,505,505,505,505,505,505,505,505,505,505,505,505,505,505,505,505,505
496,497,505,505,505,505,505,505,505,505,505,505,505,505,505,505,505,505,505,505,505,505,505,505,505,505,587,630,505,505,505,505,505,505,505,505,505,505,505,505,505,505,505,505,505,505,505,505,630,505,505,505,505,505,505,505,505,505,586,505,505,505,505,505,505,631,505,505,505,505,505,586,505,505,505,505,505,505,505,505
496,497,505,505,505,505,505,505,505,505,505,505,505,505,505,505,505,505,505,505,505,505,505,505,505,631,505,505,505,505,505,505,505,505,586,505,505,505,505,505,505,632,505,505,505,505,505,505,505,505,505,505,505,632,505,505,505,505,505,505,505,505,505,505,505,505,505,505,505,505,505,505,505,505,505,505,505,505,505,505
496,497,505,505,505,505,505,505,505,505,505,505,505,505,505,505,505,505,505,505,505,505,632,505,505,505,505,505,505,505,505,505,505,505,632,632,505,585,505,505,505,505,505,505,505,505,505,505,505,505,505,505,505,505,505,505,505,505,505,505,505,505,505,586,505,505,505,505,505,505,505,505,505,505,505,505,505,505,450,451
465,542,505,505,505,505,505,505,505,505,505,505,505,505,505,505,505,505,505,505,505,505,631,505,505,505,505,505,505,505,505,505,505,505,505,505,505,505,586,505,505,505,505,505,505,505,505,505,505,505,505,505,505,505,505,505,505,505,505,505,505,505,505,505,505,630,505,505,505,505,505,505,505,505,505,505,450,451,511,496
542,505,505,505,505,505,505,505,505,505,505,505,505,505,505,505,505,505,505,505,505,505,505,505,505,505,505,505,505,505,505,505,505,505,505,505,505,505,505,505,505,505,505,630,586,505,505,505,505,505,505,505,505,505,505,505,505,505,505,505,505,505,505,505,505,505,505,450,451,451,451,451,451,451,451,451,511,496,496,496
505,505,505,505,505,505,505,505,505,505,505,505,505,505,505,505,505,505,505,505,505,505,505,505,505,505,505,505,505,505,505,505,505,505,505,505,505,505,505,505,505,505,505,505,505,505,505,505,505,505,505,586,505,631,630,505,587,505,505,505,630,505,505,505,505,505,450,511,496,496,496,496,496,496,496,496,496,496,496,496
505,505,505,505,505,505,505,505,505,505,505,505,505,505,505,505,505,586,505,505,505,505,505,505,505,505,505,505,505,505,505,505,505,505,505,585,505,505,505,505,505,505,505,505,505,630,505,505,505,505,505,505,505,505,505,505,505,505,505,505,505,505,505,505,505,450,511,496,496,496,496,496,496,496,496,496,496,496,496,496
505,505,505,505,505,586,632,505,505,505,631,505,505,505,505,505,505,505,505,505,505,632,505,505,505,505,587,505,631,505,505,505,505,505,585,505,505,505,505,505,505,505,505,505,505,632,505,505,505,505,505,505,505,631,505,505,505,505,505,505,505,505,505,505,505,495,496,496,496,496,496,496,496,496,496,496,496,496,496,496
505,505,505,505,505,505,505,505,505,631,505,632,505,505,505,505,505,632,505,505,505,505,505,505,505,505,505,505,505,505,505,505,630,505,505,505,505,586,631,505,505,505,505,505,505,505,505,630,505,505,505,505,505,505,505,505,505,505,505,505,505,450,451,451,451,511,496,496,496,496,496,496,496,496,496,496,496,496,496,496
505,505,505,505,505,505,505,505,505,505,505,505,505,505,505,505,505,585,505,505,505,505,505,505,505,505,505,505,505,587,505,505,587,505,505,505,505,505,505,505,505,505,587,505,505,505,505,505,505,505,505,505,505,505,505,505,505,505,505,505,450,511,496,496,496,496,496,496,496,496,496,496,496,496,496,496,496,496,496,496
505,505,505,505,505,505,505,505,505,505,505,505,505,505,505,505,505,505,505,505,505,505,505,505,505,505,505,505,505,505,505,505,630,632,505,505,505,505,505,505,505,505,505,505,505,505,505,505,505,505,505,505,586,505,505,505,505,505,505,450,511,496,496,496,496,496,496,496,496,496,496,496,496,496,496,496,496,496,496,465
505,505,505,505,505,505,505,505,505,505,505,505,505,505,505,505,505,505,505,505,505,505,505,505,505,505,505,632,505,505,505,505,505,505,505,505,505,505,505,505,505,505,505,505,505,505,505,505,505,505,505,505,505,505,505,505,505,505,450,511,496,496,496,496,496,590,496,496,496,496,496,496,496,496,496,496,496,465,541,542
631,505,505,505,505,505,505,505,505,505,505,505,505,505,505,505,505,505,505,587,585,505,505,505,505,505,505,505,505,505,505,505,505,505,505,505,505,505,505,505,505,505,505,505,505,505,505,505,505,505,632,505,505,505,505,505,450,451,511,496,496,496,496,496,496,496,589,496,496,496,496,496,496,496,465,541,541,542,505,505
505,505,505,505,505,505,505,505,505,505,505,505,505,505,505,505,505,505,505,505,505,505,505,505,505,505,505,505,505,505,505,505,505,505,505,505,505,505,505,505,505,505,505,505,505,505,505,631,585,587,585,505,505,505,505,505,495,496,496,496,496,496,496,496,496,496,496,496,496,465,541,541,541,541,542,505,505,505,505,505
505,505,505,505,505,505,505,505,505,505,505,505,505,505,630,505,505,505,505,505,505,505,505,505,505,587,630,505,505,505,505,505,505,505,505,505,505,505,505,505,505,505,505,505,505,505,586,505,505,505,505,505,505,505,450,451,511,634,589,496,496,496,496,496,496,496,496,465,541,542,505,505,505,505,505,505,505,631,505,587
587,505,505,505,505,505,505,505,505,505,505,505,505,587,505,505,505,505,505,505,585,505,505,505,505,505,630,505,505,505,505,505,505,505,631,505,505,505,505,505,505,585,505,505,505,505,505,505,505,505,505,505,505,505,495,496,588,496,496,633,496,496,496,496,496,496,465,542,505,585,505,505,505,505,505,505,505,505,505,505
505,505,505,505,505,505,505,505,505,505,631,505,505,505,505,505,505,505,505,505,587,505,505,505,505,505,505,505,586,631,586,505,505,505,505,505,505,505,505,505,505,505,505,505,505,505,505,505,505,505,505,505,450,451,511,588,635,496,496,465,541,541,541,541,541,541,542,505,505,505,505,505,505,505,505,632,505,587,505,505
505,505,505,505,505,505,505,505,505,505,505,505,505,505,505,505,505,505,505,505,505,505,505,587,505,505,505,505,505,505,505,505,505,505,505,505,505,505,505,505,505,505,505,505,505,505,505,505,505,505,450,451,511,496,496,496,496,465,541,542,505,505,505,505,505,505,585,505,505,587,505,586,505,505,505,450,451,451,451,451
505,505,505,505,505,505,505,505,505,505,505,505,505,505,505,505,505,505,505,505,505,505,505,505,505,505,505,505,505,505,505,505,505,505,505,505,505,505,505,505,505,505,505,505,505,505,505,505,450,451,511,590,496,496,465,541,541,542,505,505,585,505,631,505,505,505,505,505,505,505,505,505,505,450,451,511,496,496,496,496
505,505,505,505,505,505,505,505,505,505,505,505,586,505,505,587,632,505,505,505,505,505,505,505,505,505,505,505,632,505,505,505,505,505,505,505,505,505,505,505,505,505,505,505,505,505,505,450,511,496,496,496,465,541,542,505,505,505,631,505,585,505,505,505,505,587,505,631,505,505,450,451,451,511,496,496,496,496,496,496
505,505,505,505,505,505,505,505,505,505,505,505,505,505,505,505,505,505,505,505,505,505,505,505,505,505,505,505,505,505,505,505,505,505,505,505,505,505,505,505,505,505,505,505,450,451,451,511,496,496,465,541,542,505,505,505,585,505,505,505,632,505,505,505,505,505,505,505,505,450,511,496,496,496,496,496,496,496,496,496
505,505,505,505,505,505,505,505,505,505,505,505,505,505,505,505,505,505,632,505,505,505,505,586,505,505,505,505,505,505,505,505,505,505,505,505,505,505,505,505,505,450,451,451,511,588,590,496,465,541,542,505,505,505,631,587,505,505,450,451,452,505,450,451,452,505,450,451,451,511,496,496,496,496,496,496,496,496,496,496
505,505,505,505,505,505,505,505,505,505,586,505,505,505,505,505,505,505,505,505,586,505,505,505,505,505,505,505,505,505,505,505,505,505,505,505,505,450,451,451,451,511,496,496,633,496,465,541,542,505,505,632,505,505,631,630,505,505,495,496,497,450,511,496,510,451,511,496,496,496,496,496,496,496,496,496,496,496,496,496
