55,55,55,55,55,55,55,55,0,1,2,55,55,280,280,280,280,280,280,280,280,280,280,280,280,280,280,280,280,280,280,280,280,280,280,280,280,280,280,280,280,280,280,280,280,280,280,280,280,280,280,280,280,280,280,280,280,280,280,280,280,280,280,280,280,280,280,280,280,280,280,280,280,280,280,280,280,280,280,280
55,55,55,55,55,55,55,0,61,46,47,55,55,280,280,280,280,280,280,280,280,280,280,280,280,280,280,280,280,280,280,280,280,280,280,280,280,280,280,280,280,280,280,280,280,280,280,280,280,280,280,280,280,280,280,280,280,280,280,280,280,280,280,280,280,280,280,280,280,280,280,280,280,280,280,280,280,280,280,280
55,55,55,136,55,55,55,45,46,185,47,55,55,280,280,280,280,280,280,280,280,280,280,280,280,280,280,280,280,280,280,280,280,280,280,280,280,280,280,280,280,280,280,280,280,280,280,280,280,280,280,280,280,280,280,280,280,280,280,280,280,280,280,280,280,280,280,280,280,280,280,280,280,280,280,280,280,280,280,280
55,55,55,55,55,55,55,45,46,46,47,55,55,280,280,280,280,280,280,280,280,280,280,280,280,280,280,280,280,280,280,280,280,280,280,280,280,280,280,280,280,280,280,280,280,280,280,280,280,280,280,280,280,280,280,280,280,280,280,280,280,280,280,280,280,280,280,280,280,280,280,280,280,280,280,280,280,280,280,280
55,55,55,55,55,55,55,45,46,46,60,2,55,280,280,280,280,280,280,280,280,280,280,280,280,280,280,280,280,280,280,280,280,280,280,280,280,280,280,280,280,280,280,280,280,280,280,280,280,280,280,280,280,280,280,280,280,280,280,280,280,280,280,280,280,280,280,280,280,280,280,280,280,280,280,280,280,280,280,280
55,55,55,55,55,55,55,90,16,46,46,47,55,280,280,280,280,280,280,280,280,280,280,280,280,280,280,280,280,280,280,280,280,280,280,280,280,280,280,280,280,280,280,280,280,280,280,280,280,280,280,280,280,280,280,280,280,280,280,280,280,280,280,280,280,280,280,280,280,280,280,280,280,280,280,280,280,280,280,280
135,55,55,55,55,55,55,0,61,46,46,47,55,280,280,280,280,280,280,280,280,280,280,280,280,280,280,280,280,280,280,280,280,280,280,280,280,280,280,280,280,280,280,280,280,280,280,280,280,280,280,280,280,280,280,280,280,280,280,280,280,280,280,280,280,280,280,280,280,280,280,280,280,280,280,280,280,280,280,280
180,55,55,55,55,55,0,61,183,46,15,92,55,280,280,280,280,280,280,280,280,280,280,280,280,280,280,280,280,280,280,280,280,280,280,280,280,280,280,280,280,280,280,280,280,280,280,280,280,280,280,280,280,280,280,280,280,280,280,280,280,280,280,280,280,280,280,280,280,280,280,280,280,280,280,280,280,280,280,280
55,55,55,55,55,55,45,185,46,15,92,55,55,280,280,280,280,280,280,280,280,280,280,280,280,280,280,280,280,280,280,280,280,280,280,280,280,280,280,280,280,280,280,280,280,280,280,280,280,280,280,280,280,280,280,280,280,280,280,280,280,280,280,280,280,280,280,280,280,280,280,280,280,280,280,280,280,280,280,280
55,55,55,55,55,55,45,140,15,92,55,55,55,280,280,280,280,280,280,280,280,280,280,280,280,280,280,280,280,280,280,280,280,280,280,280,280,280,280,280,280,280,280,280,280,280,280,280,280,280,280,280,280,280,280,280,280,280,280,280,280,280,280,280,280,280,280,280,280,280,280,280,280,280,280,280,280,280,280,280
55,55,55,55,55,55,45,46,47,55,55,55,55,280,280,280,280,280,280,280,280,280,280,280,280,280,280,280,280,280,280,280,280,280,280,280,280,280,280,280,280,280,280,280,280,280,280,280,280,280,280,280,280,280,280,280,280,280,280,280,280,280,280,280,280,280,280,280,280,280,280,280,280,280,280,280,280,280,280,280
55,55,55,55,55,55,45,184,47,55,55,55,55,280,280,280,280,280,280,280,280,280,280,280,280,280,280,280,280,280,280,280,280,280,280,280,280,280,280,280,280,280,280,280,280,280,280,280,280,280,280,280,280,280,280,280,280,280,280,280,280,280,280,280,280,280,280,280,280,280,280,280,280,280,280,280,280,280,280,280
55,55,55,55,55,0,61,46,47,55,55,55,55,280,280,280,280,280,280,280,280,280,280,280,280,280,280,280,280,280,280,280,280,280,280,280,280,280,280,280,280,280,280,280,280,280,280,280,280,280,280,280,280,280,280,280,280,280,280,280,280,280,280,280,280,280,280,280,280,280,280,280,280,280,280,280,280,280,280,280
55,55,55,55,0,61,139,46,47,55,55,55,55,280,280,280,280,280,280,280,280,280,280,280,280,280,280,280,280,280,280,280,280,280,280,280,280,280,280,280,280,280,280,280,280,280,280,280,280,280,280,280,280,280,280,280,280,280,280,280,280,280,280,280,280,280,280,280,280,280,280,280,280,280,280,280,280,280,280,280
55,55,55,55,45,46,46,15,92,55,55,55,55,280,280,280,280,280,280,280,280,280,280,280,280,280,280,280,280,280,280,280,280,280,280,280,280,280,280,280,280,280,280,280,280,280,280,280,280,280,280,280,280,280,280,280,280,280,280,280,280,280,280,280,280,280,280,280,280,280,280,280,280,280,280,280,280,280,280,280
55,55,55,55,45,46,46,47,55,55,55,55,55,280,280,280,280,280,280,280,280,280,280,280,280,280,280,280,280,280,280,280,280,280,280,280,280,280,280,280,280,280,280,280,280,280,280,280,280,280,280,280,280,280,280,280,280,280,280,280,280,280,280,280,280,280,280,280,280,280,280,280,280,280,280,280,280,280,280,280
55,55,55,55,45,46,46,47,55,55,55,55,55,280,280,280,280,280,280,280,280,280,280,280,280,280,280,280,280,280,280,280,280,280,280,280,280,280,280,280,280,280,280,280,280,280,280,280,280,280,280,280,280,280,280,280,280,280,280,280,280,280,280,280,280,280,280,280,280,280,280,280,280,280,280,280,280,280,280,280
55,55,55,0,61,185,46,47,55,55,55,55,55,280,280,280,280,280,280,280,280,280,280,280,280,280,280,280,280,280,280,280,280,280,280,280,280,280,280,280,280,280,280,280,280,280,280,280,280,280,280,280,280,280,280,280,280,280,280,280,280,280,280,280,280,280,280,280,280,280,280,280,280,280,280,280,280,280,280,280
55,55,55,45,46,46,15,92,55,55,55,55,55,280,280,280,280,280,280,280,280,280,280,280,280,280,280,280,280,280,280,280,280,280,280,280,280,280,280,280,280,280,280,280,280,280,280,280,280,280,280,280,280,280,280,280,280,280,280,280,280,280,280,280,280,280,280,280,280,280,280,280,280,280,280,280,280,280,280,280
55,55,0,61,138,15,92,55,55,55,55,55,55,280,280,280,280,280,280,280,280,280,280,280,280,280,280,280,280,280,280,280,280,280,280,280,280,280,280,280,280,280,280,280,280,280,280,280,280,280,280,280,280,280,280,280,280,280,280,280,280,280,280,280,280,280,280,280,280,280,280,280,280,280,280,280,280,280,280,280
55,55,45,46,139,47,55,55,55,55,55,55,55,280,280,280,280,280,280,280,280,280,280,280,280,280,280,280,280,280,280,280,280,280,280,280,280,280,280,280,280,280,280,280,280,280,280,280,280,280,280,280,280,280,280,280,280,280,280,280,280,280,280,280,280,280,280,280,280,280,280,280,280,280,280,280,280,280,280,280
55,55,45,183,46,47,55,55,55,55,55,55,55,280,280,280,280,280,280,280,280,280,280,280,280,280,280,280,280,280,280,280,280,280,280,280,280,280,280,280,280,280,280,280,280,280,280,280,280,280,280,280,280,280,280,280,280,280,280,280,280,280,280,280,280,280,280,280,280,280,280,280,280,280,280,280,280,280,280,280
55,0,61,46,46,47,55,55,55,55,55,55,55,280,280,280,280,280,280,280,280,280,280,280,280,280,280,280,280,280,280,280,280,280,280,280,280,280,280,280,280,280,280,280,280,280,280,280,280,280,280,280,280,280,280,280,280,280,280,280,280,280,280,280,280,280,280,280,280,280,280,280,280,280,280,280,280,280,280,280
55,45,46,46,15,92,55,55,55,55,55,55,55,280,280,280,280,280,280,280,280,280,280,280,280,280,280,280,280,280,280,280,280,280,280,280,280,280,280,280,280,280,280,280,280,280,280,280,280,280,280,280,280,280,280,280,280,280,280,280,280,280,280,280,280,280,280,280,280,280,280,280,280,280,280,280,280,280,280,280
55,45,46,140,60,1,1,2,55,55,55,55,55,280,280,280,280,280,280,280,280,280,280,280,280,280,280,280,280,280,280,280,280,280,280,280,280,280,280,280,280,280,280,280,505,505,505,505,505,505,505,505,280,280,280,280,280,280,280,280,280,280,280,280,280,280,280,280,280,280,280,280,280,280,280,280,280,280,280,280
55,45,46,183,46,139,46,47,55,55,55,55,55,280,280,280,280,280,280,280,280,280,280,280,280,280,280,280,280,280,280,280,280,280,280,280,280,280,280,280,280,280,280,505,505,505,450,451,451,451,451,452,505,505,280,280,280,280,280,280,280,280,280,280,280,280,280,280,280,280,280,280,280,280,280,280,280,280,280,280
55,45,46,46,46,185,15,92,55,55,55,55,55,280,280,280,280,280,280,280,280,280,280,280,280,280,280,280,280,280,280,280,280,280,280,280,280,280,280,280,280,280,505,505,450,451,511,496,496,496,496,497,505,505,505,505,280,280,280,280,280,280,280,280,280,280,280,280,280,280,280,280,280,280,280,280,280,280,280,280
55,45,46,140,46,138,47,55,55,55,55,55,55,280,280,280,280,280,280,280,280,280,280,280,280,280,280,280,280,280,280,280,280,280,280,280,280,280,280,280,280,505,505,505,495,496,496,496,590,633,496,510,451,451,452,505,505,280,280,280,280,280,280,280,280,280,280,280,280,280,280,280,280,280,280,280,280,280,280,280
55,45,46,46,46,15,92,55,55,55,55,55,55,280,280,280,280,280,280,280,280,280,280,280,280,280,280,280,280,280,280,280,280,280,280,280,280,280,280,280,280,505,505,450,511,496,496,496,496,496,496,496,496,496,510,452,505,505,280,280,280,280,280,280,280,280,280,280,280,280,280,280,280,280,280,280,280,280,280,280
0,61,46,46,15,92,55,55,55,55,55,55,55,280,280,280,280,280,280,280,280,280,280,280,280,280,280,280,280,280,280,280,280,280,280,280,280,280,280,280,280,505,450,511,496,635,496,496,496,496,496,496,496,496,496,510,452,505,505,280,280,280,280,280,280,280,280,280,280,280,280,280,280,280,280,280,280,280,280,280
45,46,46,46,47,55,55,55,55,55,55,55,55,280,280,280,280,280,280,280,280,280,280,280,280,280,280,280,280,280,280,280,280,280,280,280,280,280,280,280,505,450,511,496,496,496,496,496,496,496,496,496,496,496,496,496,510,452,505,280,280,280,280,280,280,280,280,280,280,280,280,280,280,280,280,280,280,280,280,280
90,91,91,91,92,55,55,55,55,55,55,55,55,280,280,280,280,280,280,280,280,280,280,280,280,280,280,280,280,280,280,280,280,280,280,280,280,280,280,280,505,495,496,496,590,496,465,466,496,465,541,466,496,496,496,496,496,497,505,280,280,280,280,280,280,280,280,280,280,280,280,280,280,280,280,280,280,280,280,280
55,55,55,55,55,55,55,55,55,55,55,55,55,280,280,280,280,280,280,280,280,280,280,280,280,280,280,280,280,280,280,280,280,280,280,280,280,280,280,505,505,495,588,590,496,634,497,540,541,542,505,540,466,496,635,496,496,497,505,505,280,280,280,280,280,280,280,280,280,280,280,280,280,280,280,280,280,280,280,280
55,55,55,55,55,55,55,55,55,55,55,55,55,280,280,280,280,280,280,280,280,280,280,280,280,280,280,280,280,280,280,280,280,280,280,280,280,280,280,505,505,495,496,465,541,541,542,505,505,505,505,505,540,541,466,588,496,497,505,505,280,280,280,280,280,280,280,280,280,280,280,280,280,280,280,280,280,280,280,280
55,55,55,55,55,55,55,55,55,55,55,55,55,280,280,280,280,280,280,280,280,280,280,280,280,280,280,280,280,280,280,280,280,280,280,280,280,280,280,505,505,495,496,497,505,505,505,505,505,505,505,505,505,505,540,466,635,497,505,505,280,280,280,280,280,280,280,280,280,280,280,280,280,280,280,280,280,280,280,280
55,55,55,55,55,55,55,55,55,55,55,55,55,280,280,280,280,280,280,280,280,280,280,280,280,280,280,280,280,280,280,280,280,280,280,280,280,280,280,505,505,540,541,542,587,505,505,505,505,505,587,505,505,505,505,495,496,497,505,505,280,280,280,280,280,280,280,280,280,280,280,280,280,280,280,280,280,280,280,280
55,55,55,55,55,55,55,55,55,55,55,55,55,280,280,280,280,280,280,280,280,280,280,280,280,280,280,280,280,280,280,280,280,280,280,280,280,280,280,505,505,505,505,505,505,505,505,505,505,505,505,505,505,505,505,540,541,542,505,505,280,280,280,280,280,280,280,280,280,280,280,280,280,280,280,280,280,280,280,280
55,55,55,55,55,55,55,55,55,55,55,55,55,280,280,280,280,280,280,280,280,280,280,280,280,280,280,280,280,280,280,280,280,280,280,280,280,280,280,505,505,505,505,505,505,505,505,505,505,505,505,505,505,505,505,505,505,505,505,505,280,280,280,280,280,280,280,280,280,280,280,280,280,280,280,280,280,280,280,280
55,55,55,55,55,55,55,55,55,55,55,55,55,280,280,280,280,280,280,280,280,280,280,280,280,280,280,280,280,280,280,280,280,280,280,280,280,280,505,505,505,505,505,505,505,505,505,505,505,505,632,505,505,505,505,505,505,505,505,505,505,280,280,280,280,280,280,280,280,280,280,280,280,280,280,280,280,280,280,280
55,55,55,55,55,55,55,55,55,55,55,55,55,280,280,280,280,280,280,280,280,280,280,280,280,280,280,280,280,280,280,280,280,280,280,280,280,280,505,505,505,505,505,505,505,505,505,505,505,505,505,505,632,630,505,631,505,505,505,505,505,280,280,280,280,280,280,280,280,280,280,280,280,280,280,280,280,280,280,280
55,55,55,55,55,55,55,55,55,55,55,55,55,280,280,280,280,280,280,280,280,280,280,280,280,280,280,280,280,280,280,280,280,280,280,280,280,280,505,505,505,505,505,505,505,630,505,505,505,505,505,505,505,505,505,505,505,505,505,505,505,280,280,280,280,280,280,280,280,280,280,280,280,280,280,280,280,280,280,280
55,55,55,55,55,55,55,55,55,55,55,55,55,280,280,280,280,280,280,280,280,280,280,280,280,280,280,280,280,280,280,280,280,280,280,280,280,280,280,505,505,505,505,505,505,505,505,505,505,505,505,505,630,505,505,505,505,505,505,505,505,280,280,280,280,280,280,280,280,280,280,280,280,280,280,280,280,280,280,280
55,55,55,55,55,55,55,55,55,55,55,55,55,280,280,280,280,280,280,280,280,280,280,280,280,280,280,280,280,280,280,280,280,280,280,280,280,280,280,505,505,505,505,505,505,505,505,505,505,505,631,505,505,505,505,505,505,505,505,505,505,280,280,280,280,280,280,280,280,280,280,280,280,280,280,280,280,280,280,280
55,55,55,55,55,55,280,280,280,280,280,280,280,280,280,280,280,280,280,280,280,280,280,280,280,280,280,280,280,280,280,280,280,280,280,280,280,280,280,280,505,505,505,585,505,505,505,505,505,505,505,505,505,505,505,505,505,505,505,505,505,280,280,280,280,280,280,280,280,280,280,280,280,280,280,280,280,280,280,280
55,55,55,55,55,55,280,280,280,280,280,280,280,280,280,280,280,280,280,280,280,280,280,280,280,280,280,280,280,280,280,280,280,280,280,280,280,280,280,280,505,505,505,505,505,505,505,505,632,505,505,505,505,505,505,505,505,505,505,505,505,280,280,280,280,280,280,280,280,280,280,280,280,280,280,280,280,280,280,280
55,55,55,55,55,55,280,280,280,280,280,280,280,280,280,280,280,280,280,280,280,280,280,280,280,280,280,280,280,280,280,280,280,280,280,280,280,280,280,280,505,505,505,505,505,505,505,505,505,505,505,585,505,505,505,505,505,505,505,505,505,280,280,280,280,280,280,280,280,280,280,280,280,280,280,280,280,280,280,280
55,55,55,55,55,55,280,280,280,280,280,280,280,280,280,280,280,280,280,280,280,280,280,280,280,280,280,280,280,407,280,280,280,280,280,280,280,280,280,280,280,505,505,505,505,631,505,505,505,505,505,505,505,505,505,505,505,505,505,505,505,280,280,280,280,280,280,280,280,280,280,280,280,280,280,280,280,280,280,280
55,55,55,55,55,55,280,280,280,280,280,280,280,280,280,280,280,280,280,280,280,280,280,280,280,280,280,280,280,360,280,280,280,280,280,280,280,280,280,280,280,505,450,451,452,505,505,505,505,505,587,505,505,505,505,505,505,505,505,505,505,280,280,280,280,280,280,280,280,280,280,280,280,280,280,280,280,280,280,280
55,55,55,55,55,55,280,280,280,280,280,280,280,280,280,280,280,280,280,280,280,280,280,280,280,280,280,280,280,280,280,280,280,280,280,280,280,280,280,280,280,505,495,496,497,505,505,505,505,505,505,505,630,505,505,505,505,505,505,505,505,280,280,280,280,280,280,280,280,280,280,280,280,280,280,280,280,280,280,280
55,55,55,55,55,55,280,280,280,280,280,280,280,280,280,280,280,280,280,280,280,280,280,280,280,280,280,280,280,280,280,280,280,280,280,280,280,280,280,280,280,505,495,496,510,452,505,505,505,505,505,505,505,505,505,505,505,505,505,505,505,280,280,280,280,280,280,280,280,280,280,280,280,280,280,280,280,280,280,280
55,55,55,55,55,55,280,280,280,280,280,280,280,280,280,280,280,280,280,280,280,280,280,280,280,280,280,280,280,405,280,280,280,280,280,280,280,280,280,280,280,505,495,496,496,510,452,505,505,505,505,505,587,505,505,505,505,505,505,505,505,280,280,280,280,280,280,280,280,280,280,280,280,280,280,280,280,280,280,280
55,55,55,55,55,55,280,280,280,280,280,280,280,280,280,280,280,280,280,280,280,280,280,280,280,280,280,280,280,280,360,280,280,280,280,280,280,280,280,280,280,505,495,496,496,496,497,505,505,505,505,505,505,505,505,505,505,505,505,505,505,280,280,280,280,280,280,280,280,280,280,280,280,280,280,280,280,280,280,280
55,55,55,55,55,55,280,280,280,280,280,280,280,280,280,280,280,280,280,280,280,280,280,280,225,226,226,227,280,280,361,406,280,280,280,280,280,280,280,280,280,505,495,496,634,465,542,505,505,505,505,505,505,505,505,505,632,505,505,505,505,280,280,280,280,280,280,280,280,280,280,280,280,280,280,280,280,280,280,280
55,55,55,55,55,55,280,280,280,280,280,280,280,280,280,280,280,280,280,280,280,280,225,226,286,271,271,272,280,280,280,280,280,280,280,280,280,280,280,280,280,505,495,589,589,497,505,505,505,505,505,505,505,505,505,505,505,586,505,505,505,280,280,280,280,280,280,280,280,280,280,280,280,280,280,280,280,280,280,280
55,55,55,55,55,55,280,280,280,280,280,280,280,280,280,280,280,280,280,280,280,225,286,271,271,271,240,317,280,280,280,280,280,280,280,280,280,280,280,280,280,505,495,496,590,497,505,505,631,505,505,505,505,505,505,631,505,505,505,505,505,280,280,280,280,280,280,280,280,280,280,280,280,280,280,280,280,280,280,280
55,55,55,55,55,55,280,280,280,280,280,280,280,280,280,280,280,280,280,280,280,270,271,271,271,240,317,360,280,280,280,280,280,280,280,280,280,280,280,280,280,505,540,466,496,510,452,505,505,505,505,505,505,505,505,505,505,505,505,505,505,280,280,280,280,280,280,280,280,280,280,280,280,280,280,280,280,280,280,280
55,55,55,55,55,55,280,280,280,280,280,280,280,280,280,280,280,280,280,326,225,286,271,271,240,317,280,280,280,280,407,280,280,280,280,280,280,280,280,280,280,505,505,495,496,634,497,505,505,505,505,505,505,505,505,505,505,586,505,505,505,505,280,280,280,280,280,280,280,280,280,280,280,280,280,280,280,280,280,280
55,55,55,55,55,55,280,280,280,280,280,280,280,280,280,280,280,280,280,225,286,271,271,271,272,280,280,280,280,280,280,280,280,280,280,280,280,280,280,280,280,280,505,495,496,496,497,505,505,505,505,505,505,505,505,587,585,505,632,632,505,505,280,280,280,280,280,280,280,280,280,280,280,280,280,280,280,280,280,280
55,55,55,55,55,55,280,280,280,280,280,280,280,280,280,280,280,280,280,270,271,271,271,271,285,227,280,280,280,280,280,280,280,280,280,280,280,280,280,280,280,280,505,540,541,541,542,505,505,505,632,505,505,631,505,505,505,505,505,505,505,505,280,280,280,280,280,280,280,280,280,280,280,280,280,280,280,280,280,280
55,55,55,55,55,55,280,280,280,280,280,280,280,280,280,280,280,280,225,286,271,271,271,271,271,285,227,280,280,280,280,280,280,280,280,280,280,280,280,280,280,280,280,505,505,505,505,587,505,505,631,505,505,505,505,505,505,505,505,505,505,505,280,280,280,280,280,280,280,280,280,280,280,280,280,280,280,280,280,280
55,55,55,55,55,55,280,280,280,280,280,280,280,280,280,280,280,280,270,271,271,271,271,271,271,271,285,227,280,280,280,280,280,280,280,280,280,280,280,280,280,280,280,505,505,505,505,505,505,505,505,505,505,505,505,505,505,505,505,505,505,505,280,280,280,280,280,280,280,280,280,280,280,280,280,280,280,280,280,280
55,55,55,55,55,55,280,280,280,280,280,280,280,280,280,280,280,280,270,271,271,271,271,240,241,271,271,272,280,280,280,280,280,280,280,280,280,280,280,280,280,280,280,280,505,505,505,505,505,505,505,505,505,505,505,505,505,505,505,505,505,505,280,280,280,280,280,280,280,280,280,280,280,280,280,280,280,280,280,280
280,280,280,280,280,280,280,280,280,280,280,280,280,280,280,280,280,225,286,271,271,271,271,285,286,271,271,285,227,280,280,280,280,280,280,360,280,280,280,280,280,280,280,280,505,505,587,505,505,505,586,505,505,505,505,505,505,505,505,505,505,505,505,280,280,280,280,280,280,280,280,280,280,280,280,280,280,280,280,280
280,280,280,280,280,280,280,280,280,280,280,280,280,280,280,280,280,270,271,271,271,271,271,271,271,271,271,271,272,280,280,280,280,280,280,361,280,280,280,280,280,280,280,280,505,505,505,505,505,505,505,505,505,505,505,505,505,505,505,505,505,505,505,280,280,280,280,280,280,280,280,280,280,280,280,280,280,280,280,280
280,280,280,280,280,280,280,280,280,280,280,280,280,280,280,280,280,270,271,271,271,271,271,271,271,271,271,271,285,227,280,280,280,280,280,361,280,280,280,280,280,280,280,280,280,505,505,505,505,505,505,505,505,505,505,505,450,451,451,451,452,505,505,280,280,280,280,280,280,280,280,280,280,280,280,280,280,280,280,280
280,280,280,280,280,280,280,280,280,280,280,280,280,280,280,280,280,270,271,271,271,271,271,271,271,271,240,241,271,272,280,280,280,280,280,280,280,280,280,280,280,280,280,280,280,505,505,505,505,631,505,505,505,505,505,505,495,496,496,496,497,505,505,280,280,280,280,280,280,280,280,280,280,280,280,280,280,280,280,280
280,280,280,280,280,280,280,280,280,280,280,280,280,280,280,280,280,270,271,271,271,271,271,271,271,271,285,286,271,272,280,280,280,280,280,280,280,280,280,280,280,280,280,280,280,505,505,505,505,630,505,505,505,505,505,505,495,496,496,496,510,452,505,280,280,280,280,280,280,280,280,280,280,280,280,280,280,280,280,280
280,280,280,280,280,280,280,280,280,280,280,280,280,280,280,280,280,270,271,271,271,271,271,271,271,271,271,271,271,272,280,280,280,280,280,280,280,360,280,280,280,280,280,280,280,505,505,505,505,505,505,505,505,505,505,505,495,496,496,588,496,497,505,505,280,280,280,280,280,280,280,280,280,280,280,280,280,280,280,280
280,280,280,280,280,280,280,280,280,280,280,280,280,280,280,280,280,270,271,271,271,271,271,271,271,271,271,271,271,285,226,227,280,280,280,280,280,360,280,280,280,280,280,280,280,280,280,505,505,505,505,505,586,505,505,505,540,466,496,588,496,510,452,505,280,280,280,280,280,280,280,280,280,280,280,280,280,280,280,280
280,280,280,280,280,280,280,280,280,280,280,407,360,280,280,280,225,286,271,271,271,271,271,271,271,271,271,271,271,271,271,285,227,280,280,280,280,280,280,280,280,280,280,280,280,280,280,505,505,505,505,505,505,505,505,505,505,495,496,633,496,496,497,505,280,280,280,280,280,280,280,280,280,280,280,280,280,280,280,280
280,280,280,280,280,280,280,280,280,280,280,280,360,280,280,280,270,271,271,271,271,271,271,271,271,271,271,271,271,271,271,271,272,280,280,280,280,280,280,280,280,280,280,280,280,280,280,505,505,505,587,505,505,505,505,505,505,540,466,590,496,496,497,505,280,280,280,280,280,280,280,280,280,280,280,280,280,280,280,280
280,280,280,280,280,280,280,280,280,280,280,280,280,280,280,280,270,271,271,271,271,271,271,271,271,271,271,271,271,271,271,271,272,280,280,280,280,280,280,280,280,280,280,280,280,280,280,505,505,505,505,505,505,505,505,505,505,505,495,496,496,496,510,452,505,280,280,280,280,280,280,280,280,280,280,280,280,280,280,280
280,280,280,280,280,280,280,280,280,280,280,280,280,280,280,280,270,271,271,271,271,271,271,271,271,271,271,271,271,271,271,271,285,227,280,280,280,280,280,280,280,280,280,280,280,280,280,505,505,505,505,632,585,505,505,505,505,505,540,466,633,588,634,497,505,280,280,280,280,280,280,280,280,280,280,280,280,280,280,280
280,280,280,280,280,280,280,280,280,280,280,280,280,280,280,280,270,271,271,271,271,271,271,271,271,271,271,271,271,271,271,271,271,285,227,280,280,280,280,280,280,280,280,280,280,280,280,505,505,505,505,505,505,505,505,587,505,505,505,540,466,496,633,497,505,280,280,280,280,280,280,280,280,280,280,280,280,280,280,280
280,280,280,280,280,280,280,280,280,280,280,280,280,280,280,280,270,271,271,271,271,271,271,271,271,271,271,271,271,271,271,271,271,271,272,280,280,280,280,280,280,280,280,280,280,280,280,505,505,505,505,505,505,505,585,505,505,505,505,505,540,466,589,510,452,505,280,280,280,280,280,280,280,280,280,280,280,280,280,280
280,280,280,280,280,280,280,360,280,280,280,280,280,280,280,280,270,271,271,271,271,271,271,271,271,271,271,271,271,271,271,271,271,271,285,227,280,280,280,280,280,280,280,280,280,280,280,505,505,505,505,505,505,505,631,505,585,505,505,505,505,495,496,496,497,505,280,280,280,280,280,280,280,280,280,280,280,280,280,280
280,280,280,280,280,280,280,362,361,280,280,360,280,280,280,280,270,271,271,271,271,271,271,271,271,271,271,271,271,271,271,271,271,271,271,272,280,280,280,280,280,280,280,280,280,280,280,505,505,505,505,505,505,505,505,505,630,505,505,505,505,540,466,590,497,505,280,280,280,280,280,280,280,280,280,280,280,280,280,280
280,280,280,280,280,280,280,405,280,280,280,280,280,280,280,280,270,271,271,271,271,271,271,271,271,271,271,271,271,271,271,271,271,271,271,285,227,280,280,280,280,280,280,280,280,280,280,505,505,505,505,505,505,505,505,505,632,505,505,505,505,505,540,541,542,505,280,280,280,280,280,280,280,280,280,280,280,280,280,280
280,280,280,280,280,280,280,280,280,280,280,280,280,280,280,280,270,271,271,271,271,271,271,271,271,271,271,271,271,271,271,271,271,271,271,271,285,227,280,280,280,280,280,280,280,280,292,505,505,505,505,505,505,505,505,505,586,505,505,505,505,505,505,505,505,505,280,280,280,280,280,280,280,280,280,280,280,280,280,280
280,280,280,280,280,280,280,280,280,280,280,280,280,280,280,280,270,271,271,271,271,271,271,271,271,271,271,271,271,271,271,271,271,271,271,271,271,272,280,280,280,280,280,280,280,280,281,450,451,451,451,452,505,505,505,505,632,505,505,505,505,505,505,505,505,505,280,280,280,280,280,280,280,280,280,280,280,280,280,280
