55,55,55,55,55,55,55,55,55,55,55,55,55,55,55,55,55,45,46,46,15,91,92,55,55,55,55,55,55,55,55,55,55,55,55,55,55,55,55,55,55,55,55,0,1,61,46,46,184,15,46,280,280,280,280,280,225,226,286,271,271,271,271,271,271,271,285,286,271,271,271,271,271,271,271,271,271,271,271,271
55,55,55,55,55,55,55,55,55,55,55,55,55,55,55,55,0,61,46,15,92,55,55,55,55,55,55,182,55,55,55,55,55,55,55,55,181,55,55,55,55,55,0,61,185,46,46,46,46,46,280,280,280,225,226,226,286,271,271,271,271,271,271,271,271,271,271,271,271,271,271,271,271,271,271,271,271,271,271,271
55,55,55,55,55,55,55,55,55,55,55,55,55,55,55,0,61,46,46,47,55,55,55,55,55,55,55,55,55,55,181,55,55,182,55,55,55,55,55,55,55,0,61,183,184,46,138,46,46,280,225,226,226,286,271,271,271,271,271,271,271,271,271,271,271,271,271,271,271,271,271,271,271,271,271,271,271,271,271,271
55,55,55,55,55,55,55,55,55,55,55,55,55,0,1,61,46,46,46,47,55,55,55,55,55,55,55,55,55,55,55,55,182,55,55,55,55,55,55,0,1,61,46,184,46,46,46,46,280,225,286,271,271,271,271,271,271,271,271,271,271,271,271,271,271,271,271,271,271,271,271,240,316,241,271,271,271,271,271,271
55,55,55,55,55,55,55,55,55,55,55,55,55,45,46,46,46,46,46,47,55,55,55,55,55,55,55,55,55,55,55,55,55,55,55,55,55,55,0,61,46,46,46,46,46,46,280,280,225,286,271,271,240,241,271,271,271,271,271,271,271,271,271,271,271,271,271,271,271,271,240,317,280,270,271,271,271,271,271,271
55,55,55,55,55,55,55,55,55,55,0,1,1,61,46,46,46,46,15,92,55,55,55,55,55,55,55,55,55,55,55,55,55,55,55,55,55,0,61,46,183,46,46,46,46,280,280,280,270,271,271,271,285,286,271,271,271,271,271,271,271,271,271,271,271,271,271,271,271,271,272,280,280,315,316,241,271,271,271,271
55,55,55,55,55,55,55,55,55,0,61,46,46,46,46,46,46,15,92,55,55,55,55,55,55,55,55,55,55,55,135,136,55,55,0,1,1,61,46,138,46,46,46,280,280,280,225,226,286,271,271,271,271,271,271,271,271,271,271,271,271,271,271,271,271,271,271,271,271,271,272,280,280,280,280,315,316,316,316,316
55,55,55,55,55,55,55,55,55,45,46,46,46,46,46,46,15,92,55,55,55,55,55,55,55,55,55,55,55,55,55,0,1,1,61,46,46,138,46,138,46,46,280,225,226,226,286,271,271,271,271,271,271,271,271,271,271,271,271,271,271,271,271,271,271,271,271,271,271,271,272,280,280,280,280,280,280,280,280,280
55,55,55,55,55,55,55,55,55,45,46,46,46,46,46,46,60,1,1,1,1,2,55,55,55,55,55,55,180,0,1,61,46,185,46,46,46,46,46,46,46,280,280,270,271,271,271,271,271,271,271,271,271,271,271,271,271,271,271,271,271,271,271,271,271,271,271,271,271,271,272,280,280,280,280,280,280,280,280,280
55,55,55,55,55,55,55,55,55,45,46,46,140,46,46,183,46,46,46,46,46,60,2,55,55,55,55,55,0,61,46,46,46,46,46,46,271,46,46,46,280,406,280,270,271,271,271,271,271,271,271,271,271,271,271,271,271,271,271,271,271,271,271,271,271,271,271,271,271,240,317,280,280,280,280,280,280,280,280,280
55,55,55,55,55,55,55,55,55,45,46,46,46,46,46,46,46,46,183,46,138,46,60,1,1,1,1,1,61,46,46,46,46,46,46,270,271,46,46,280,280,280,280,270,271,271,271,271,271,271,271,271,271,271,271,271,271,271,271,271,271,271,271,271,271,271,271,271,240,317,405,280,280,280,280,280,280,280,280,280
55,55,55,55,55,55,55,55,0,61,46,140,46,46,46,46,46,46,46,46,46,184,46,46,46,139,46,46,46,46,46,46,46,46,280,315,316,280,280,280,280,280,280,270,271,271,271,271,271,271,271,271,271,271,271,271,271,271,271,271,271,271,271,271,271,271,271,240,317,280,406,280,280,280,280,280,280,280,280,280
55,55,55,55,55,55,55,55,45,138,46,46,46,46,46,46,46,46,46,46,46,46,138,46,46,46,46,46,46,46,46,46,46,280,280,280,280,280,280,280,280,280,280,315,241,271,271,271,271,271,271,271,271,271,271,271,271,271,271,271,271,271,271,271,271,240,316,317,280,280,280,280,280,280,280,280,280,280,280,280
55,55,55,55,55,55,55,55,45,46,46,46,46,46,46,46,46,46,46,46,46,46,46,46,46,46,46,46,46,46,46,15,280,280,280,280,280,280,280,280,280,280,280,280,270,271,271,271,271,271,271,271,271,271,271,271,271,271,271,271,271,271,271,240,316,317,280,280,280,280,280,280,280,280,280,280,280,280,280,280
55,55,55,55,55,55,55,0,61,184,46,46,46,46,46,46,46,46,46,46,46,46,46,46,46,46,46,46,46,46,280,280,280,280,280,280,280,280,280,280,280,280,280,280,270,271,271,271,271,271,271,271,271,271,271,271,271,271,271,271,271,271,271,272,280,280,280,280,280,280,280,407,362,280,280,280,280,280,280,280
55,55,55,55,55,55,55,45,46,140,46,46,46,46,46,46,46,46,46,46,46,46,46,46,46,46,46,46,15,91,280,280,280,280,280,362,280,406,407,360,280,280,280,280,315,241,271,271,271,271,271,271,271,271,271,271,271,271,271,271,271,240,316,317,280,280,280,280,280,280,280,405,280,280,280,280,280,280,362,280
55,55,55,55,55,55,55,45,46,46,46,46,46,46,46,46,46,46,46,46,46,46,46,46,15,91,91,91,92,55,280,280,280,280,362,407,406,280,280,280,280,280,360,360,280,315,316,316,241,271,271,271,271,271,271,271,271,271,271,271,240,317,280,280,280,280,280,280,280,280,362,280,280,280,280,280,280,280,362,280
55,55,55,55,55,55,0,61,46,46,46,46,46,46,46,46,46,46,46,46,46,46,46,15,92,55,55,55,280,280,280,280,280,280,280,280,280,280,280,280,280,280,280,360,280,280,280,280,315,316,241,271,271,271,271,271,271,271,240,316,317,280,280,280,280,280,280,280,280,280,406,280,280,280,280,280,280,280,280,280
55,55,55,55,55,55,45,46,46,46,46,46,46,46,46,46,46,46,46,46,46,46,46,47,55,280,280,280,280,280,280,280,280,280,280,280,280,280,280,280,280,280,280,361,280,280,280,280,280,280,270,271,271,271,271,271,271,240,317,280,280,280,280,280,280,280,280,280,280,280,406,280,280,280,280,280,280,280,280,280
55,55,55,55,55,0,61,46,46,46,46,46,46,46,46,46,46,46,46,46,15,91,317,280,280,280,280,407,280,280,362,280,280,280,280,280,361,280,280,280,280,280,280,280,280,280,280,280,407,360,270,271,271,271,271,240,316,317,280,280,280,280,280,280,280,280,280,280,280,407,280,280,280,280,280,280,280,280,280,280
55,55,55,55,0,61,46,46,46,46,46,46,46,46,46,46,46,46,15,91,92,55,280,280,280,280,280,280,280,405,280,280,280,280,280,280,280,280,280,280,280,280,280,280,280,280,280,280,280,280,315,316,316,316,316,317,280,280,280,280,280,280,280,280,280,280,360,362,280,280,280,280,280,280,280,280,280,280,280,280
55,55,55,55,45,46,46,46,46,46,46,46,46,46,15,91,91,91,92,55,55,280,280,280,280,280,280,280,280,280,280,280,280,361,280,280,280,280,280,280,280,280,280,280,280,280,280,280,280,280,280,280,280,280,280,280,280,280,361,280,280,280,280,280,280,280,280,280,280,280,280,280,280,280,280,280,280,280,280,280
1,1,1,1,61,46,46,46,46,46,46,46,15,91,92,55,55,280,280,280,280,280,280,280,280,280,280,280,280,280,280,280,280,280,280,361,280,280,280,280,280,280,280,280,280,280,407,360,280,280,280,280,280,280,280,280,280,280,280,280,280,280,280,280,280,280,280,280,280,280,280,280,280,280,280,280,280,280,280,280
280,46,46,46,46,46,46,46,46,15,91,91,92,55,280,280,280,280,280,280,280,280,280,280,280,280,280,280,280,280,280,280,280,280,280,280,280,280,405,280,280,280,280,280,280,280,280,361,280,280,280,280,280,280,280,280,280,280,280,280,280,280,280,280,280,280,280,280,280,280,280,280,280,280,280,407,361,280,280,280
280,91,91,91,91,91,91,91,91,92,280,280,280,280,280,280,280,280,280,225,226,226,227,280,280,280,280,280,280,361,280,280,280,280,280,280,280,280,280,280,280,280,280,280,280,280,280,280,280,280,280,280,280,280,280,280,280,405,280,280,280,280,407,280,280,280,280,280,280,280,280,280,280,280,280,280,280,280,280,280
280,280,280,280,55,55,280,280,280,280,280,280,280,280,280,280,280,280,280,270,271,271,272,280,280,280,280,280,280,280,280,280,405,280,280,280,280,280,280,280,280,280,280,280,280,280,280,280,360,280,280,280,280,280,280,280,280,407,280,280,361,406,405,280,280,280,280,280,280,280,280,280,280,280,280,280,280,280,280,280
280,280,280,280,55,280,280,280,280,280,280,280,280,280,280,225,226,226,227,315,241,271,272,280,280,280,280,361,280,280,280,280,280,280,280,280,280,280,280,280,280,280,280,280,280,280,280,280,280,280,280,280,280,280,280,280,280,405,406,280,280,280,280,280,280,280,280,280,280,280,280,280,280,280,280,405,280,280,280,280
280,280,280,280,280,280,280,280,280,280,280,280,280,280,225,286,271,271,285,226,286,271,272,280,280,280,280,362,280,280,280,280,280,280,280,280,280,280,280,280,280,280,280,280,280,280,280,280,280,280,280,280,280,280,280,280,280,280,280,280,280,280,280,280,280,280,280,280,280,280,362,280,280,280,280,280,280,280,280,280
280,280,280,280,225,226,226,227,225,226,226,226,226,226,286,271,271,271,271,271,271,240,317,280,280,280,280,362,362,405,280,280,280,280,280,280,280,280,280,280,280,280,280,280,280,280,280,280,280,280,280,280,280,280,280,280,280,280,280,280,280,280,280,280,280,361,280,280,280,280,280,280,280,280,280,280,280,280,280,280
280,280,280,280,270,271,271,285,286,271,271,271,271,271,271,271,271,271,271,271,271,285,227,280,280,280,280,280,280,280,407,280,280,280,280,280,280,280,360,280,280,362,280,280,280,280,280,280,280,280,280,280,280,280,280,280,280,280,280,280,280,280,280,280,360,405,280,280,280,280,280,280,280,280,280,280,280,280,280,280
280,280,280,280,270,271,271,271,271,271,271,271,271,271,271,271,271,271,271,271,271,271,272,280,280,280,280,280,280,280,280,280,280,280,280,280,280,280,362,280,280,362,280,280,280,280,280,280,360,407,406,406,360,280,280,280,361,280,280,280,280,280,280,280,280,280,280,280,280,280,280,406,280,280,280,280,280,280,280,280
280,280,280,280,270,271,271,271,271,271,271,271,271,271,271,271,271,271,271,271,271,271,285,227,280,280,280,280,280,406,280,280,280,280,280,280,280,280,280,280,280,280,280,280,280,280,280,280,406,280,362,407,280,280,280,280,361,280,280,280,280,280,280,280,280,361,280,280,280,280,280,405,405,280,361,280,280,280,280,280
280,280,280,280,315,316,241,271,271,271,271,271,271,271,271,271,271,271,271,271,271,271,271,285,227,280,280,280,361,280,280,280,280,280,280,280,280,280,280,280,280,280,280,280,280,280,280,280,405,405,280,280,280,280,280,280,280,280,280,280,280,280,280,280,280,362,280,280,280,280,280,280,280,280,280,280,280,280,280,280
280,280,280,280,280,280,315,241,271,271,271,271,271,271,271,271,271,271,271,271,271,271,271,271,272,280,280,280,361,280,280,280,280,280,280,280,280,280,280,280,280,280,280,280,280,280,280,280,280,405,280,280,280,280,280,280,280,280,280,280,280,280,280,280,280,405,280,280,280,280,280,280,280,280,280,280,280,280,280,280
280,280,280,280,280,280,280,270,271,271,271,271,271,271,271,271,271,271,271,271,271,271,271,271,272,280,280,280,280,280,280,280,280,280,280,280,280,280,280,280,280,280,280,280,280,280,280,280,280,280,280,280,280,280,280,280,280,280,361,280,280,280,280,280,280,280,407,280,280,280,280,280,280,280,280,280,280,280,280,280
280,280,280,280,280,280,280,270,271,271,271,271,271,271,271,271,271,271,271,271,271,271,271,271,272,280,280,280,280,280,280,280,280,280,280,280,280,280,280,280,280,280,280,280,280,280,280,280,280,280,280,280,280,280,280,280,280,280,406,280,280,280,280,280,280,280,280,360,280,280,280,280,360,280,280,280,280,280,280,280
280,280,280,280,280,280,280,315,241,271,271,271,271,271,271,271,271,271,271,271,240,241,271,240,317,280,280,280,280,280,280,280,280,280,280,280,280,280,280,280,280,280,280,280,280,280,280,280,280,280,280,280,280,280,280,280,280,280,280,280,280,280,280,280,280,280,280,280,280,280,280,280,360,280,280,280,280,280,280,280
280,280,280,280,280,280,280,280,315,241,271,271,271,271,271,271,271,271,271,271,285,286,271,272,280,280,280,280,280,280,280,362,280,280,280,280,280,280,280,280,406,406,280,280,280,280,280,407,280,280,280,280,280,280,280,280,280,280,280,280,280,280,280,280,280,280,280,280,280,280,280,280,280,280,280,280,280,225,226,226
280,280,280,280,280,280,280,280,280,315,241,271,271,271,271,271,271,271,271,271,271,271,271,272,280,280,280,280,280,280,280,406,280,280,280,280,280,280,280,280,280,280,280,280,280,280,280,361,280,280,280,280,280,280,280,280,280,280,280,280,280,280,280,280,280,280,280,280,280,280,280,280,280,280,280,225,226,286,271,271
280,280,280,280,280,280,280,280,280,280,315,241,271,271,271,271,271,271,271,271,271,271,271,272,280,280,280,280,280,280,280,280,280,280,280,280,280,280,280,280,280,280,280,280,280,280,362,280,280,280,280,280,280,280,280,280,280,280,280,280,280,280,280,280,280,280,280,280,280,405,280,280,280,280,225,286,271,271,240,316
280,280,280,280,280,280,280,280,280,280,280,315,241,271,271,271,271,271,271,271,271,271,271,285,227,280,280,280,280,280,280,280,280,280,280,280,280,280,280,280,280,280,280,280,280,280,280,280,280,280,280,280,280,280,280,280,280,280,280,280,280,280,280,280,280,280,280,280,360,280,280,280,225,226,286,240,316,316,317,225
280,280,280,280,280,280,280,280,280,280,280,280,270,271,271,271,271,271,271,271,271,271,271,271,272,280,280,280,280,280,280,280,280,280,280,280,280,280,280,280,280,280,280,405,280,280,280,280,405,360,405,280,280,280,280,280,280,280,280,280,280,406,360,360,406,360,407,362,280,280,280,225,286,271,240,317,225,226,226,286
280,280,280,280,280,280,280,280,280,280,280,280,315,241,271,271,271,271,271,271,271,271,271,271,272,280,280,280,280,280,280,280,280,280,280,280,280,280,280,280,280,280,280,361,280,280,280,360,280,280,280,280,280,280,280,280,280,280,280,280,280,280,280,280,280,280,280,280,280,225,226,286,271,271,285,226,286,271,271,271
280,280,280,280,280,280,280,280,280,280,280,280,280,315,241,271,271,271,271,271,271,271,271,271,272,280,280,280,280,280,280,280,280,280,280,406,406,280,280,280,280,280,280,280,280,280,280,280,280,280,280,280,280,280,280,280,280,280,405,280,280,280,280,280,280,280,280,280,225,286,271,240,241,271,271,271,271,271,271,271
280,280,280,280,280,280,280,280,280,280,280,280,280,280,315,316,241,271,271,271,271,271,271,271,272,280,280,280,280,280,280,280,280,280,280,280,280,361,361,362,280,280,280,280,280,280,280,280,280,280,280,280,280,280,280,280,280,280,361,280,280,280,280,280,280,280,280,225,286,271,271,285,286,271,271,271,271,271,271,271
280,280,280,280,280,280,280,280,280,280,280,280,280,280,225,226,286,271,271,271,271,271,271,240,317,280,280,280,280,280,280,280,280,280,280,280,280,280,280,280,280,280,280,280,280,280,280,280,280,280,280,280,280,280,280,280,280,280,280,280,280,280,280,280,280,225,226,286,271,271,271,271,271,271,271,271,271,271,271,271
280,280,280,280,280,280,280,280,280,280,280,280,280,280,270,271,271,271,240,241,271,271,240,317,280,280,280,405,280,280,280,280,280,280,280,280,280,280,280,280,280,280,280,280,280,280,280,280,280,280,280,280,280,280,280,280,280,280,280,280,280,280,280,225,226,286,271,271,271,271,271,271,271,271,271,271,271,271,271,271
280,280,280,280,280,280,280,280,280,280,280,280,280,280,315,316,241,271,285,286,271,271,272,280,280,280,280,361,280,280,280,280,280,280,280,280,362,280,280,280,280,280,280,280,280,280,280,280,280,280,280,280,280,280,280,280,280,280,280,280,280,280,225,286,271,271,271,271,271,271,271,271,271,271,271,271,271,271,271,271
280,280,280,280,280,280,280,280,280,280,280,280,280,280,280,280,270,271,271,271,271,240,317,280,280,280,280,280,280,280,407,280,280,280,280,280,280,280,280,280,280,280,280,280,280,280,280,280,360,407,280,280,280,280,280,280,280,280,280,280,225,226,286,271,271,271,271,271,271,409,410,271,271,271,271,271,271,271,271,271
280,280,280,280,280,280,280,280,280,280,280,280,280,280,280,280,315,316,316,316,316,317,280,280,280,280,280,280,280,280,407,280,280,280,405,405,280,280,280,280,280,280,280,280,280,280,280,280,280,280,280,280,280,280,280,280,280,280,280,225,286,271,271,271,271,271,271,271,271,408,271,271,271,271,271,271,271,271,271,271
280,280,280,280,280,280,280,280,280,280,280,280,280,280,280,280,280,280,280,280,280,280,280,280,280,280,280,280,280,280,407,280,280,280,280,280,280,280,280,280,280,280,280,280,280,280,280,280,280,280,280,280,280,280,280,280,225,226,226,286,271,271,271,271,271,271,271,271,271,409,271,271,271,271,271,271,271,271,271,271
280,280,280,280,280,280,280,280,280,280,280,280,280,280,280,280,280,280,280,280,280,360,280,280,280,280,280,280,362,407,361,280,280,280,280,280,280,280,280,280,280,280,280,280,280,280,280,280,280,280,280,280,280,280,225,226,286,271,271,271,271,271,271,271,271,271,271,271,271,271,271,271,271,271,271,271,271,271,271,271
280,280,280,280,280,280,280,280,280,280,280,280,280,280,280,280,280,280,280,280,280,280,280,280,280,280,280,280,280,280,280,280,280,280,280,280,280,280,360,280,280,280,280,280,280,280,280,280,280,280,225,226,226,226,286,271,271,271,271,271,271,271,271,271,271,271,271,271,271,271,271,271,271,271,271,271,271,271,271,271
280,280,280,280,280,280,280,280,280,280,280,280,280,280,280,280,280,280,280,280,225,226,226,227,405,407,280,280,280,280,280,280,280,280,280,280,280,280,280,280,280,280,280,280,280,280,280,280,225,226,286,271,271,271,271,271,271,271,271,271,271,271,271,271,364,271,271,271,271,271,271,271,271,271,271,271,271,271,271,271
280,280,280,280,280,280,280,280,280,280,280,280,280,280,280,280,280,280,280,280,270,271,271,272,280,280,280,280,280,280,280,280,280,280,280,280,280,280,280,280,280,280,280,280,280,280,225,226,286,271,271,271,271,271,271,271,271,271,271,271,271,271,271,271,271,271,271,271,271,271,271,271,271,271,271,271,271,271,271,271
280,280,280,280,280,280,280,280,280,280,280,280,280,280,280,280,280,280,280,280,315,241,271,285,226,226,226,226,227,280,280,280,280,280,280,280,280,280,280,280,225,226,226,226,226,226,286,271,271,271,271,271,271,271,271,271,271,271,271,271,271,271,271,271,271,271,271,271,271,271,271,271,271,271,271,271,271,271,271,271
280,280,280,280,280,280,280,280,280,280,280,280,280,280,280,280,280,280,280,280,280,315,241,271,271,271,271,271,285,226,226,226,227,280,280,280,280,280,280,225,286,271,271,271,271,271,271,271,271,271,271,271,271,271,271,271,271,271,271,271,271,271,271,271,271,271,271,271,271,271,271,271,271,271,271,271,271,271,271,271
280,280,280,280,280,280,280,280,280,280,280,280,280,280,280,280,280,280,280,280,280,280,315,241,271,271,271,271,271,271,271,271,285,226,226,226,226,226,226,286,271,271,271,271,271,271,271,240,241,271,271,271,271,271,271,271,271,271,271,271,271,271,271,271,271,271,271,271,271,409,271,271,271,271,271,271,271,271,271,271
280,280,280,280,280,280,280,280,280,280,280,280,280,280,280,280,280,280,280,280,280,280,280,315,241,271,271,271,271,271,271,271,271,271,271,271,271,271,271,271,271,271,271,271,271,271,271,285,286,271,271,271,271,271,271,271,271,271,271,271,271,271,271,271,271,271,271,271,271,363,410,271,271,271,271,271,271,271,271,271
280,280,280,280,280,280,280,280,280,280,280,280,280,280,280,280,280,280,280,280,280,280,280,280,270,271,271,271,271,271,271,271,271,271,271,271,271,271,271,271,271,271,271,271,271,271,271,271,271,271,271,271,271,271,271,271,271,271,271,271,271,271,271,271,271,409,271,271,271,271,271,271,271,271,271,271,271,271,271,271
280,280,280,280,280,280,280,280,280,280,280,280,280,280,280,280,280,280,280,280,280,280,280,280,315,241,271,271,271,271,271,271,271,271,271,271,271,271,271,271,271,271,271,271,271,271,271,271,271,271,271,271,271,271,271,271,271,271,271,271,271,271,271,271,271,271,271,271,271,271,271,271,271,271,271,271,271,271,271,271
280,280,280,280,280,280,280,280,280,280,280,280,280,280,280,280,280,280,280,280,280,280,280,280,280,315,241,271,271,271,271,271,271,271,271,271,271,271,271,271,271,271,271,271,271,271,271,271,271,271,271,271,271,271,271,271,271,271,271,271,271,271,271,271,271,271,271,271,271,271,271,271,271,271,271,271,271,271,271,271
280,280,280,280,280,280,280,280,280,280,280,280,280,280,280,280,280,280,280,280,280,280,280,280,280,280,315,316,241,271,271,271,271,240,241,271,271,271,271,271,271,271,271,271,271,271,271,271,271,271,271,271,271,271,271,271,408,363,363,365,364,410,363,363,271,271,271,271,271,271,271,271,271,271,271,365,271,271,271,271
280,280,280,280,280,280,280,280,280,280,280,280,280,280,280,280,280,280,280,280,280,280,280,280,280,280,280,280,315,241,271,271,271,285,286,271,271,271,271,271,271,271,271,271,271,271,271,271,271,271,271,271,271,271,271,271,271,271,271,271,271,271,271,271,271,271,271,271,271,271,271,271,271,271,271,408,271,271,271,271
280,280,280,280,280,280,280,280,280,280,280,280,280,280,280,280,280,280,280,280,280,280,280,280,280,280,280,280,280,315,316,316,241,271,271,271,271,271,271,271,271,271,271,271,271,271,271,271,271,271,271,271,271,271,271,271,271,271,271,271,271,271,271,271,271,271,410,271,271,271,271,271,271,271,271,364,271,408,271,271
280,280,280,280,280,280,280,280,280,280,280,280,280,280,280,280,280,280,280,280,280,280,280,280,280,280,280,280,280,280,280,280,315,316,316,241,271,271,271,271,271,271,271,271,271,271,271,271,271,271,271,271,271,271,271,271,271,271,271,271,271,271,271,271,271,271,271,271,271,271,271,271,271,271,363,271,271,408,271,271
280,280,280,280,280,280,280,280,280,280,280,280,280,280,280,280,280,280,280,280,280,280,280,280,280,280,280,280,280,280,280,280,280,280,280,315,316,241,271,271,271,271,271,271,240,241,271,271,271,271,271,271,271,271,271,271,271,271,271,271,271,271,271,271,271,271,271,271,271,271,271,271,271,271,271,271,409,271,271,271
280,280,280,280,280,280,280,280,280,280,280,280,280,280,280,280,280,280,280,280,280,280,280,280,280,280,280,280,280,280,280,280,280,280,280,280,280,315,316,316,241,271,271,271,285,286,271,271,271,271,271,271,240,241,271,271,271,271,271,271,271,271,271,271,271,271,271,271,271,271,365,271,271,271,271,271,271,271,271,271
280,280,280,280,280,280,280,280,280,280,280,280,280,280,280,280,280,280,280,280,280,280,280,280,280,280,280,280,280,280,280,280,280,280,280,280,280,280,280,280,315,241,271,271,271,271,271,271,271,271,271,271,285,286,271,271,271,271,271,271,271,271,271,271,271,271,271,271,271,271,408,271,271,271,271,271,271,271,271,271
280,280,280,280,280,280,280,280,280,280,280,280,280,280,280,280,280,280,280,280,280,280,280,280,280,280,280,280,280,280,280,280,280,280,280,280,280,280,280,280,280,315,241,271,271,271,271,271,271,271,271,271,271,271,271,271,271,271,271,271,271,271,271,271,271,271,271,271,271,271,271,271,271,271,271,271,271,271,271,271
280,280,280,280,280,280,280,280,280,280,280,280,280,280,280,280,280,280,280,280,280,280,280,280,280,280,280,280,280,280,280,280,280,280,280,280,280,280,280,280,280,280,315,241,271,271,271,271,271,271,271,271,271,271,271,271,271,271,271,271,271,271,271,271,271,271,271,271,271,271,271,271,271,271,271,271,271,271,271,271
280,280,280,280,280,280,280,280,280,280,280,280,280,280,280,280,280,280,280,280,280,280,280,280,280,280,280,280,280,280,280,280,280,280,280,280,280,280,280,280,280,280,280,315,241,271,271,271,271,271,271,271,271,271,271,271,271,271,271,271,271,271,271,271,271,271,271,271,271,271,271,271,271,271,271,271,271,271,271,271
280,280,280,280,280,280,280,280,280,280,280,280,280,280,280,280,280,280,280,280,280,280,280,280,280,280,280,280,280,280,280,280,280,280,280,280,280,280,280,280,280,280,280,280,315,316,241,271,271,271,271,271,271,271,271,271,271,271,271,271,271,271,271,271,271,271,271,271,271,271,271,271,271,271,271,271,271,271,271,271
280,280,280,280,280,280,280,280,280,280,280,280,280,280,280,280,280,280,280,280,280,280,280,280,280,280,280,280,280,280,280,280,280,280,280,280,280,280,280,280,280,280,280,280,280,280,315,241,271,271,271,271,271,271,271,271,271,271,271,271,271,271,271,271,363,409,271,271,271,271,271,410,271,271,271,271,271,271,271,271
280,280,280,280,280,280,280,280,280,280,280,280,280,280,280,280,280,280,280,280,280,280,280,280,280,280,280,280,280,280,280,280,280,280,280,280,280,280,280,280,280,280,280,280,280,280,280,315,241,271,271,271,271,271,271,271,271,271,271,271,271,271,271,271,271,271,271,271,271,271,271,271,271,271,271,271,271,271,271,271
280,280,280,280,280,280,280,280,280,280,280,280,280,280,280,280,280,280,280,280,280,280,280,280,280,280,280,280,280,280,280,280,280,280,280,280,280,280,280,280,280,280,280,280,280,280,280,280,315,241,271,271,271,271,271,271,271,271,271,271,271,271,271,271,271,271,271,271,271,271,271,271,271,271,271,271,271,408,271,271
280,280,280,280,280,280,280,280,280,280,280,280,280,280,280,280,280,280,280,280,280,280,280,280,280,280,280,280,280,280,280,280,280,280,280,280,280,280,280,280,280,280,280,280,280,280,280,280,280,315,241,271,271,271,271,271,271,271,271,271,271,271,271,271,271,271,271,271,271,271,271,271,271,271,271,271,271,271,271,271
280,280,280,280,280,280,280,280,280,280,280,280,280,280,280,280,280,280,280,280,280,280,280,280,280,280,280,280,280,280,280,280,280,280,280,280,280,280,280,280,280,280,280,280,280,280,280,280,280,280,270,271,271,271,271,271,271,271,271,271,271,271,271,271,271,271,271,271,271,271,271,271,271,271,271,271,271,271,271,271
280,280,280,280,280,280,280,280,280,280,280,280,280,280,280,280,280,280,280,280,280,280,280,280,280,280,280,280,280,280,280,280,280,280,280,280,280,280,280,280,280,280,280,280,280,280,280,280,280,280,315,241,271,271,240,241,271,271,271,271,271,271,271,271,271,271,271,271,271,271,271,271,271,271,271,271,271,271,271,271
280,280,280,280,280,280,280,280,280,280,280,280,280,280,280,280,280,280,280,280,280,280,280,280,280,280,280,280,280,280,280,280,280,280,280,280,280,280,280,280,280,280,280,280,280,280,280,280,280,280,280,270,271,271,285,286,271,271,271,271,271,271,271,271,271,271,271,271,271,271,271,271,271,271,271,271,271,271,271,271
