46,60,2,55,55,90,16,46,46,46,185,140,185,46,46,46,46,46,46,46,46,46,46,46,46,46,46,46,46,46,46,46,46,46,46,46,46,140,46,46,184,46,46,60,2,55,55,55,55,55,55,55,55,55,55,55,55,46,46,46,46,46,46,46,46,46,46,46,46,46,46,46,46,46,46,46,46,46,46,46
46,46,60,2,55,55,45,140,46,46,46,46,46,46,139,46,46,46,46,46,46,46,46,46,46,46,46,46,46,46,46,46,46,46,46,46,46,46,46,46,184,46,46,46,60,1,1,1,1,1,1,2,55,55,55,55,55,55,55,46,46,46,46,46,46,46,46,46,46,46,46,46,46,46,46,46,46,46,46,46
16,46,46,47,55,55,45,185,46,46,46,46,46,138,138,185,46,46,46,46,46,46,46,46,46,46,46,46,46,46,46,46,46,46,46,46,46,46,46,46,46,139,184,46,138,46,46,46,46,46,46,60,1,1,1,2,55,55,55,55,55,55,55,55,55,55,55,46,46,46,46,46,46,46,46,46,46,46,46,46
45,46,46,47,55,55,45,46,46,46,46,138,185,183,183,185,46,46,183,46,46,46,46,46,46,46,46,46,46,46,46,46,46,46,46,46,46,46,46,46,46,140,140,46,46,183,46,46,140,46,46,139,139,140,46,60,1,1,1,2,55,55,55,55,55,55,55,55,55,55,55,55,46,46,46,46,46,46,46,46
45,46,46,47,55,55,45,46,184,140,184,46,46,46,46,46,46,140,46,46,46,46,140,139,46,46,46,46,46,46,46,46,46,46,46,46,46,46,46,46,46,46,185,46,46,46,183,185,46,46,138,46,46,46,46,46,46,46,46,60,1,1,1,2,55,55,55,55,55,55,55,55,55,55,55,46,46,46,46,46
45,46,15,92,55,55,90,16,46,46,46,46,46,184,185,139,183,184,46,46,46,46,46,46,46,46,46,46,46,46,46,46,46,46,46,46,46,46,46,46,46,46,46,46,46,46,46,46,46,46,46,184,46,46,184,46,46,46,46,46,46,46,46,60,1,1,1,1,1,2,180,182,55,55,137,55,55,46,46,46
45,46,47,55,55,137,55,90,91,91,91,16,46,46,46,46,46,185,185,184,46,46,46,46,46,46,184,46,46,46,184,138,46,46,46,46,46,46,46,46,46,46,46,46,46,46,46,46,46,46,46,46,46,46,46,185,138,46,46,46,46,46,46,46,46,139,46,139,138,60,2,55,55,55,55,181,55,55,46,46
45,46,47,55,55,55,55,180,55,55,55,90,91,91,91,91,91,91,91,16,46,46,46,183,138,138,140,46,46,185,46,46,46,46,46,46,46,46,46,46,46,46,46,46,46,46,46,46,46,46,46,46,46,46,46,46,46,138,46,46,46,46,138,46,46,46,46,46,46,46,60,2,55,55,137,55,55,55,91,16
45,46,60,2,55,55,55,55,55,55,181,55,55,137,55,55,55,55,55,90,91,16,46,46,46,139,184,46,46,139,46,46,46,46,46,46,46,46,46,46,46,46,46,46,46,46,46,46,46,46,46,46,46,46,46,183,184,46,46,46,46,46,46,46,46,46,138,46,138,46,46,47,55,55,55,55,55,55,0,61
45,46,46,47,55,55,55,55,55,55,55,55,55,136,55,55,135,55,55,55,55,90,91,91,16,46,46,46,46,185,46,46,46,46,46,46,46,46,46,46,46,46,46,46,46,46,46,46,46,46,46,46,46,46,46,46,46,46,46,46,46,46,46,46,46,140,140,46,140,46,46,47,55,182,55,55,180,55,45,46
45,46,46,47,55,55,55,55,55,55,55,55,55,55,55,55,55,55,55,55,55,55,55,55,90,91,16,46,46,183,184,46,46,46,46,46,46,46,46,46,46,46,46,46,46,46,46,46,46,46,46,46,46,46,46,46,46,46,15,16,46,46,46,46,46,46,184,46,46,46,46,47,55,55,55,55,55,55,45,46
45,46,46,60,2,55,55,55,55,55,55,55,55,55,55,55,55,55,55,55,55,55,55,182,55,55,90,16,46,46,185,46,46,46,46,46,46,46,46,46,46,46,46,46,46,46,46,46,46,46,46,46,46,46,46,46,46,46,60,61,46,46,46,46,46,46,46,46,46,46,46,47,55,55,55,55,55,55,45,46
45,46,46,46,47,55,55,55,55,55,55,55,55,55,55,55,55,55,55,55,55,55,55,55,55,55,55,90,16,46,46,46,46,46,46,46,46,46,46,46,46,46,46,46,46,46,46,46,46,46,46,46,46,46,46,46,46,46,46,46,46,46,46,46,46,46,46,184,46,15,16,47,55,55,181,55,55,55,90,16
45,46,46,46,47,55,55,55,55,55,55,55,55,55,55,55,55,55,55,55,55,55,55,55,55,135,55,55,45,140,139,46,46,185,46,46,46,46,46,46,46,46,46,46,46,46,46,46,46,46,46,46,46,46,46,46,46,46,46,46,46,46,46,46,46,15,16,46,46,47,45,47,55,55,55,55,0,1,1,61
45,46,46,46,60,2,55,55,55,55,55,55,55,55,55,55,55,55,55,55,55,55,55,55,55,55,137,55,90,16,46,46,185,46,46,46,46,46,46,46,46,46,46,46,46,46,46,46,46,46,46,46,46,46,46,46,46,46,46,46,46,46,46,46,46,60,61,46,15,92,45,47,55,55,55,55,45,46,46,46
45,46,46,46,46,60,2,55,55,55,55,55,55,55,55,55,55,55,55,55,55,55,55,55,55,55,182,55,55,45,46,46,46,46,46,46,46,46,46,46,46,46,46,46,46,46,46,46,46,46,46,46,46,46,46,46,46,46,46,46,46,46,46,46,46,46,140,15,92,0,61,47,55,55,55,55,90,16,46,15
45,46,46,46,46,46,47,55,55,55,55,55,55,55,55,55,55,55,55,55,55,55,55,55,55,55,135,55,55,90,16,46,46,46,46,46,46,46,46,46,46,46,46,46,46,46,46,46,46,46,46,46,46,46,46,46,46,46,46,46,46,15,91,16,46,46,46,60,1,61,15,92,55,55,55,55,55,90,91,92
45,46,46,46,46,46,60,2,55,0,1,1,2,55,55,55,55,55,55,55,55,55,55,55,55,55,55,55,55,55,45,46,46,46,15,16,46,46,46,46,46,46,46,46,46,46,46,46,46,46,46,46,46,46,46,46,46,46,46,15,91,92,0,61,46,46,46,46,46,15,92,55,55,55,55,55,55,55,55,55
45,46,46,46,46,46,46,60,1,61,46,46,47,55,55,55,55,55,55,55,55,55,55,55,55,55,55,55,55,55,45,46,46,46,47,90,16,46,46,46,46,46,46,46,46,46,46,46,46,46,46,46,46,46,46,46,46,46,15,92,0,1,61,46,46,46,46,46,15,92,55,55,55,55,55,55,55,55,55,55
45,46,46,46,46,46,46,46,46,46,46,15,92,55,55,55,0,1,1,2,55,55,55,55,55,55,55,55,55,55,90,16,46,183,60,1,61,46,46,183,46,46,46,46,46,46,46,46,46,46,46,46,46,46,46,46,46,46,60,1,61,138,138,46,46,46,15,91,92,55,55,55,55,55,55,55,55,55,55,55
45,46,46,46,46,46,183,184,46,46,185,60,1,1,2,55,45,46,46,60,2,55,55,55,55,55,55,55,55,55,55,90,16,46,46,46,184,139,15,16,185,46,46,46,46,46,46,46,46,46,46,185,46,46,46,46,46,46,46,46,46,46,46,46,15,91,92,55,55,55,55,55,55,55,55,55,55,55,137,55
45,46,46,46,46,46,46,138,184,46,138,46,46,46,60,1,61,46,46,46,60,1,2,55,55,55,55,55,55,135,55,55,90,91,16,138,46,46,47,90,91,16,46,140,46,138,46,46,46,46,46,184,46,46,46,138,184,46,184,184,46,46,15,91,92,55,55,180,55,55,55,55,55,55,55,55,55,55,55,55
61,46,46,46,46,46,46,184,46,46,46,15,91,16,46,184,138,138,46,46,46,46,60,1,2,55,55,55,55,55,55,55,180,55,90,91,16,46,60,1,1,61,46,184,46,46,183,46,46,46,46,46,46,46,184,140,184,138,46,46,15,91,92,55,135,55,55,55,55,55,55,55,55,55,55,55,55,55,55,55
46,46,46,46,46,46,46,183,46,15,91,92,55,90,91,16,46,46,46,46,46,46,46,46,47,55,55,55,55,55,55,55,180,55,55,55,90,91,16,46,46,46,46,15,91,91,16,139,140,184,183,184,139,138,140,46,46,46,46,15,92,55,55,55,55,55,55,55,55,55,55,55,55,55,55,55,55,55,55,55
46,46,46,46,46,46,46,46,15,92,55,55,55,55,55,90,91,91,91,91,91,91,16,138,60,1,2,55,55,55,55,55,55,55,55,55,55,136,90,91,91,16,46,60,1,1,61,46,46,185,185,46,46,139,46,46,46,46,46,47,55,55,136,55,55,55,55,55,55,55,55,55,55,55,55,55,55,135,180,55
46,46,46,46,46,46,46,46,47,55,55,55,55,55,55,55,55,55,55,55,55,55,45,140,46,46,60,2,55,55,55,55,55,55,55,55,55,55,55,55,55,90,91,91,16,46,46,46,46,46,46,46,46,46,46,46,46,46,15,92,55,55,136,55,55,55,55,55,55,55,55,55,55,55,55,55,55,55,55,55
46,46,46,46,46,46,46,46,47,55,55,55,55,55,55,55,55,55,55,55,55,55,90,91,16,46,46,60,2,55,55,55,55,55,55,55,55,55,55,55,55,55,55,55,90,91,16,140,46,46,15,91,16,46,46,46,15,91,92,136,55,55,55,55,55,55,55,55,55,55,55,55,55,55,55,55,55,55,55,55
46,46,46,46,46,46,46,46,60,2,55,55,55,55,55,55,55,55,55,55,55,55,55,55,90,16,46,46,47,55,55,55,55,55,55,55,55,55,55,55,55,55,55,55,55,55,90,91,16,46,60,1,61,46,15,91,92,55,136,55,55,55,55,55,55,55,55,55,55,55,55,55,55,55,55,55,55,55,55,55
46,46,46,46,46,46,46,46,46,47,55,55,55,55,55,55,55,55,55,55,55,55,55,55,55,45,46,46,60,2,55,55,55,55,55,55,55,55,55,55,55,55,55,55,55,55,55,55,90,91,91,91,91,91,92,55,55,55,55,55,55,55,55,55,55,55,55,55,55,55,55,55,55,55,55,55,55,55,55,55
46,46,46,46,46,46,46,46,46,47,55,55,55,55,55,55,55,55,55,55,55,137,55,137,55,90,16,46,46,60,2,55,55,55,55,55,55,55,55,55,55,55,55,55,55,55,55,55,180,55,55,55,55,55,55,181,55,55,55,55,55,55,55,55,55,55,55,55,55,55,55,55,55,55,55,55,55,135,55,55
46,46,46,46,46,46,46,46,15,92,55,55,55,55,135,55,135,55,55,55,55,55,55,55,55,55,45,139,46,46,47,55,55,55,55,55,55,55,55,55,55,55,55,55,55,55,55,55,55,137,55,55,55,55,55,55,55,55,55,55,55,55,55,55,55,55,55,55,55,55,55,55,55,55,55,55,55,55,55,55
46,46,46,46,46,46,46,15,92,55,55,55,137,55,55,55,55,55,182,55,55,55,181,55,55,55,45,46,183,46,60,2,55,0,1,1,2,55,55,55,55,55,55,55,55,55,55,55,55,55,55,55,55,55,55,55,55,55,55,55,55,55,55,55,55,55,55,55,55,55,55,55,55,55,55,55,55,55,55,55
46,46,46,46,46,46,46,47,55,137,55,55,55,55,55,55,55,55,55,55,55,55,136,55,180,55,45,46,46,46,46,60,1,61,46,46,60,1,1,2,55,55,55,55,55,55,55,55,55,55,55,55,55,55,55,55,55,55,55,55,55,55,55,55,55,55,55,55,55,55,55,55,55,55,137,55,55,55,55,55
46,46,46,46,46,46,46,47,55,55,55,55,55,55,137,55,55,55,55,55,55,55,55,55,55,55,90,16,46,139,140,46,46,46,46,46,46,46,46,60,1,1,2,55,55,55,55,55,55,55,55,55,55,55,55,55,55,55,55,55,55,55,55,55,55,55,55,55,55,55,55,55,55,55,55,55,55,55,55,55
46,46,46,46,46,46,46,47,55,55,55,55,55,135,55,55,55,180,55,55,55,55,55,55,55,55,55,90,16,139,15,16,46,46,46,15,91,91,16,46,46,46,60,1,2,55,55,55,55,55,55,55,55,55,55,55,55,55,55,55,55,55,55,55,55,55,55,55,55,55,55,55,55,55,55,55,55,55,55,55
46,46,46,46,46,46,46,47,55,55,55,55,55,55,55,55,55,55,55,55,55,55,55,55,55,55,55,55,45,139,47,90,91,16,46,60,1,2,90,91,91,16,46,46,60,1,1,2,55,55,55,55,55,55,55,55,55,55,55,55,55,55,55,55,55,55,55,55,55,55,55,55,55,55,55,55,55,55,55,55
46,46,46,46,46,46,46,60,1,2,55,55,55,55,55,55,55,55,55,55,55,55,182,55,55,55,55,55,45,185,60,1,2,45,46,46,46,60,1,1,1,61,46,46,46,46,46,60,1,1,2,55,55,55,55,55,55,55,55,55,55,55,55,55,55,55,55,55,55,55,55,137,55,55,55,55,55,55,55,55
46,46,46,46,46,46,138,139,46,60,1,2,55,55,180,55,55,55,55,137,137,55,55,55,55,55,55,55,90,16,46,46,60,61,46,46,46,46,46,46,46,46,46,183,46,46,46,46,46,46,47,55,0,1,2,55,55,55,55,55,55,55,55,55,55,55,55,55,55,55,55,55,55,55,55,55,182,55,55,55
46,46,46,46,46,46,15,16,184,184,46,60,2,55,55,55,55,55,55,55,55,55,55,55,55,55,55,55,55,90,91,16,183,140,15,16,46,46,46,140,46,140,46,46,46,46,46,46,46,46,47,0,61,46,47,55,55,55,55,55,55,55,55,181,55,55,55,55,55,55,55,55,55,55,55,55,55,55,55,55
46,46,46,46,46,46,60,61,46,46,46,46,47,55,55,55,55,55,55,55,55,55,55,55,55,55,55,55,55,55,55,90,16,138,60,61,46,46,46,46,46,46,140,140,46,15,91,91,91,91,92,45,46,46,47,55,55,55,55,55,55,55,55,180,55,55,55,55,182,55,55,55,55,55,55,55,55,55,55,55
46,46,46,46,46,46,46,46,185,46,15,16,60,2,55,55,55,55,55,55,55,55,55,55,55,55,55,182,55,55,55,55,90,16,46,46,139,139,46,46,140,46,46,183,138,60,1,1,1,1,1,61,46,15,92,55,55,55,55,55,55,55,55,55,55,55,55,55,55,55,55,55,55,135,55,55,55,55,55,55
46,46,46,46,46,46,185,46,46,46,47,45,46,47,55,55,55,135,55,181,181,55,55,181,55,55,55,55,55,55,55,55,55,90,91,91,91,91,91,91,91,91,91,16,185,46,46,185,46,15,91,91,91,92,55,55,55,55,55,55,55,55,55,55,55,55,55,55,55,55,55,55,55,55,55,55,55,55,55,55
46,46,46,46,46,46,46,140,46,46,60,61,46,47,55,55,55,55,55,55,55,55,55,55,55,55,55,55,55,55,55,55,55,55,55,55,55,55,55,55,55,55,55,90,91,91,91,91,91,92,55,55,55,55,55,181,55,55,55,55,55,180,55,55,55,55,55,136,55,55,55,55,55,55,55,55,55,55,55,55
46,46,46,46,46,46,46,46,46,46,46,46,46,60,1,2,55,55,55,55,55,55,55,55,55,55,55,55,55,55,55,55,55,55,55,55,55,55,182,55,55,55,55,55,55,55,55,55,55,55,55,55,55,55,55,55,55,55,55,55,55,55,55,55,55,55,55,55,55,55,55,55,55,181,55,55,55,55,55,0
46,46,46,46,46,46,46,46,46,46,46,46,46,46,46,60,2,55,55,55,55,55,180,55,55,55,55,181,55,55,55,135,55,55,55,55,55,55,55,55,55,55,135,55,55,55,55,55,55,55,55,55,55,55,55,55,55,55,55,55,55,55,55,55,55,55,55,55,55,55,55,55,55,55,55,55,55,55,0,61
46,46,46,46,46,46,46,46,46,46,46,46,140,138,138,46,60,1,2,55,55,55,55,55,55,55,181,55,55,55,55,55,55,55,55,55,55,55,55,55,55,55,55,55,55,55,55,55,55,55,55,55,55,180,55,55,55,55,55,55,55,181,55,180,55,55,55,55,55,55,55,55,55,55,55,55,55,55,45,46
46,46,46,46,46,46,46,46,46,46,183,139,185,46,140,46,46,46,47,55,55,135,55,55,55,55,55,55,55,55,55,55,136,55,55,55,55,55,55,55,55,55,55,55,55,55,55,55,55,55,55,55,55,55,55,55,135,55,55,55,55,55,55,55,55,55,55,55,55,55,55,55,55,55,55,55,55,0,61,46
46,46,46,46,46,46,46,46,46,46,46,46,46,46,46,46,46,46,47,55,55,55,55,55,55,55,55,55,55,55,55,55,55,55,55,55,55,55,55,55,55,55,55,55,55,55,55,55,55,55,55,55,55,55,55,55,55,55,55,55,55,55,55,55,55,55,55,55,55,135,55,55,55,55,55,55,55,45,46,55
46,46,46,46,46,46,46,46,46,46,46,46,46,46,46,46,46,46,60,2,55,55,55,55,55,55,55,55,55,55,55,136,55,137,55,181,55,55,55,55,55,55,55,55,55,55,55,180,55,55,55,55,55,55,55,55,55,55,55,55,55,55,55,55,55,55,55,55,55,55,55,55,55,55,55,55,0,61,55,55
46,46,46,46,46,46,46,46,15,16,46,46,138,185,46,46,139,183,46,60,1,1,1,2,55,55,55,55,55,55,55,55,55,55,55,55,55,55,55,55,55,55,55,55,55,55,180,182,55,55,55,55,55,136,55,55,55,55,55,181,55,55,55,55,55,55,135,55,55,55,55,55,55,55,55,55,45,46,55,55
46,46,46,46,46,46,46,46,60,61,46,46,46,140,46,46,46,184,183,46,46,46,46,60,1,2,55,55,55,55,55,55,55,55,55,55,55,55,55,55,55,55,55,55,55,55,55,55,55,55,55,55,55,55,55,55,55,55,55,55,55,55,55,55,55,55,55,55,55,55,55,0,1,1,1,1,61,55,55,0
46,46,46,46,46,46,46,46,46,46,46,46,46,46,46,46,46,46,46,15,16,46,46,46,46,60,1,1,2,55,55,136,55,55,55,55,55,55,55,55,55,55,55,55,55,55,55,55,55,55,55,55,55,55,55,55,181,55,55,55,55,55,55,55,55,55,55,55,55,55,0,61,46,185,46,46,55,55,0,61
46,46,46,46,46,46,46,46,46,46,46,46,46,46,46,15,16,46,46,60,61,46,15,16,46,46,46,46,60,2,55,55,55,55,55,55,55,55,55,55,55,55,55,55,55,136,55,55,55,135,55,55,137,55,55,55,55,55,55,55,55,55,55,55,181,55,55,55,55,0,61,138,46,15,46,180,55,0,61,46
46,46,46,46,46,46,46,46,46,46,46,46,46,46,46,60,61,46,46,46,139,46,60,61,46,15,16,46,46,60,2,55,55,55,137,55,55,55,55,55,55,55,55,55,55,55,55,55,55,55,55,55,55,55,55,55,55,55,55,181,55,55,55,55,55,55,55,55,55,45,46,46,15,55,55,0,1,61,46,46
46,140,46,46,46,46,46,46,46,46,46,46,46,46,46,46,46,46,46,46,46,46,46,46,46,60,61,46,46,46,47,55,55,55,55,55,55,55,55,55,55,55,55,55,55,55,55,55,55,55,55,55,55,55,55,135,55,55,55,55,55,55,55,55,55,55,55,0,1,61,46,15,181,55,0,61,46,46,46,46
46,183,183,46,46,46,46,46,46,46,46,46,46,46,46,46,46,46,46,46,46,46,46,46,46,46,46,46,46,46,60,1,2,55,55,55,55,55,55,55,55,55,55,55,55,55,181,55,55,55,180,137,55,55,55,55,55,55,55,55,55,55,55,55,55,55,0,61,140,183,46,55,55,55,45,46,46,46,46,46
46,46,139,46,46,46,46,46,46,46,46,46,46,46,46,46,46,46,46,46,46,46,46,46,46,46,140,46,46,46,46,46,60,1,1,1,1,1,2,55,55,55,55,55,55,55,55,55,55,55,55,55,55,55,55,55,55,55,55,55,55,55,55,0,1,1,61,46,46,55,55,180,0,1,61,46,46,46,46,15
46,46,15,16,46,46,46,46,46,46,46,46,46,46,46,46,46,46,46,46,46,46,46,46,46,46,46,46,46,46,46,46,183,46,46,46,46,184,60,1,1,2,55,55,55,137,55,55,55,55,55,55,55,55,55,55,55,55,55,55,55,55,0,61,46,140,184,46,55,180,0,1,61,46,46,46,46,15,91,92
46,46,60,61,46,46,46,46,46,46,46,46,46,46,46,46,46,46,46,46,46,46,46,46,46,46,46,46,46,46,185,46,46,46,139,140,46,46,46,46,46,60,1,1,2,55,55,55,55,55,55,55,55,55,55,55,55,55,55,55,0,1,61,140,46,15,91,55,55,0,61,46,15,16,46,46,15,92,55,55
16,46,138,15,16,46,46,140,46,46,46,46,46,46,46,46,46,46,46,46,46,46,46,46,46,46,46,46,46,46,46,46,46,46,184,46,46,46,46,46,46,46,46,46,60,1,1,1,1,1,1,1,1,1,1,1,1,1,2,55,45,140,46,46,15,92,55,137,0,61,46,46,60,61,46,15,92,55,55,55
90,16,46,60,61,46,46,46,15,16,46,46,46,46,46,46,46,46,46,46,46,46,46,46,46,46,46,46,46,46,46,46,46,46,46,46,46,46,46,46,138,46,46,46,46,46,46,46,46,46,46,46,46,46,46,46,46,46,60,1,61,46,15,91,67,55,55,0,61,46,46,46,46,46,15,92,55,55,55,55
55,90,91,16,46,46,46,46,60,61,185,46,46,46,46,46,46,46,46,46,46,46,46,46,46,46,46,46,46,46,46,46,46,46,46,46,46,46,46,139,46,46,46,46,46,46,46,46,46,140,138,184,138,46,46,46,46,46,46,46,46,15,92,67,55,0,1,61,46,46,46,46,46,15,92,55,55,180,55,55
55,55,55,90,91,91,16,138,46,185,46,140,46,46,46,46,46,46,46,46,46,46,46,46,46,46,46,46,46,46,46,46,46,46,46,46,46,46,46,46,185,138,46,46,46,46,46,46,183,139,46,46,46,46,46,185,183,46,46,46,15,92,55,55,0,61,46,46,46,46,46,46,15,92,55,55,55,55,55,55
55,55,55,55,55,55,90,91,91,16,46,46,46,185,46,46,46,46,46,46,46,46,46,46,46,46,46,46,46,46,46,46,46,46,46,46,46,46,46,46,46,46,46,46,46,46,46,46,46,46,46,46,46,46,46,46,46,185,140,15,55,55,55,0,61,46,46,46,46,46,46,15,92,55,55,55,55,55,55,55
55,55,55,55,135,55,55,55,55,90,91,16,139,183,46,46,46,46,46,46,46,46,46,46,46,46,46,46,46,46,46,46,46,46,46,46,46,46,46,46,46,46,140,46,46,46,46,46,185,46,46,46,46,46,46,46,46,55,55,55,55,0,1,61,46,46,46,46,46,46,15,92,55,136,181,55,55,55,55,55
55,55,55,55,137,55,55,55,136,55,55,90,16,185,185,46,140,46,46,46,46,46,46,46,46,46,46,46,46,46,46,46,46,46,46,46,46,46,46,46,46,46,46,46,46,46,46,183,46,138,138,46,46,46,46,46,55,55,0,1,1,61,46,46,46,46,46,46,46,46,47,55,55,137,55,55,55,55,55,55
55,55,55,55,182,55,182,55,55,55,55,55,45,46,46,46,184,184,46,46,46,46,46,46,46,46,46,46,46,46,46,46,46,46,46,46,46,46,46,46,46,46,46,46,46,139,46,46,46,46,46,46,46,46,55,55,180,0,61,46,46,46,46,46,46,46,46,46,46,46,47,55,137,55,55,55,55,55,55,55
55,55,55,55,55,55,55,55,55,55,55,55,45,46,46,46,46,46,46,46,46,46,46,46,46,46,46,46,46,46,46,46,46,46,46,46,46,46,46,46,46,46,46,46,46,46,46,46,46,46,46,15,55,55,55,182,0,61,46,46,46,46,46,46,46,46,46,139,183,46,47,180,55,55,55,55,55,55,55,55
55,55,55,55,55,55,55,55,55,55,55,55,90,16,46,46,46,139,46,46,46,46,46,46,46,46,46,46,46,46,46,46,46,46,46,46,46,46,46,46,46,46,46,46,46,46,46,46,46,55,55,55,55,136,0,1,61,46,46,46,46,46,46,46,46,46,46,46,46,46,47,55,55,55,55,55,55,55,0,1
55,55,55,55,55,55,55,55,55,55,55,55,55,90,91,91,16,46,46,46,46,46,183,46,46,46,46,46,46,46,46,46,46,46,46,46,46,46,46,46,46,46,46,46,46,46,46,46,55,55,0,1,2,55,45,46,46,46,46,46,46,46,46,46,46,46,46,185,46,15,92,55,55,55,55,55,55,0,61,46
55,55,55,55,55,55,55,55,55,55,55,55,55,55,55,55,90,91,16,46,46,46,46,46,46,46,46,46,46,46,46,46,46,46,46,46,46,46,46,46,46,46,46,46,46,46,181,182,55,0,61,46,47,0,61,46,46,46,46,46,46,46,46,46,46,46,46,46,15,92,181,55,55,55,55,55,55,45,46,140
55,55,55,55,55,55,55,55,55,55,55,55,55,55,55,55,55,55,90,91,16,46,46,46,46,46,46,46,46,46,46,46,46,46,46,46,46,46,46,46,46,46,46,46,46,46,55,55,137,45,46,46,60,61,46,46,46,46,46,46,46,46,46,46,46,46,15,91,92,55,55,55,55,0,1,1,1,61,139,15
55,55,55,55,55,55,55,55,55,55,182,55,55,55,55,55,55,55,55,55,90,91,91,16,46,46,46,46,46,46,46,46,184,46,46,46,46,46,46,46,46,46,46,46,183,15,91,55,55,90,16,46,46,46,46,46,46,46,46,46,46,46,46,46,46,46,47,55,181,55,55,55,0,61,46,183,138,46,46,47
55,55,55,55,55,55,55,55,55,55,55,55,55,55,135,55,55,55,182,55,55,55,55,90,16,46,46,46,46,185,46,46,184,140,46,46,46,46,46,46,46,46,46,140,139,60,1,1,55,55,45,46,184,46,46,46,46,46,46,46,46,46,46,46,46,46,47,55,55,55,55,55,45,46,46,15,91,91,91,92
55,55,55,55,55,55,55,55,55,55,55,55,55,55,136,55,55,55,55,181,55,55,55,55,90,91,16,46,185,46,46,46,46,46,184,46,46,138,46,46,46,46,46,46,46,46,15,91,55,135,90,16,138,46,46,46,46,46,46,46,46,46,46,46,46,15,92,55,55,55,55,0,61,46,15,92,55,55,55,55
55,55,55,55,55,55,55,55,55,55,55,55,55,55,55,55,136,55,55,55,55,55,55,55,55,55,90,91,91,91,16,46,46,46,46,46,46,46,46,46,46,46,46,46,138,46,60,2,90,55,55,90,16,46,46,46,15,91,16,46,15,16,46,15,91,92,9,21,55,55,55,45,46,138,47,55,55,55,55,55
55,55,55,55,55,55,55,55,55,55,55,55,55,55,55,55,55,55,55,55,55,55,55,55,55,55,55,55,55,55,90,91,91,91,91,91,91,16,46,46,184,46,46,46,46,46,46,60,2,55,55,55,90,91,180,91,92,137,90,91,92,90,91,92,9,10,21,55,55,55,0,61,46,15,92,55,55,55,55,55
55,55,55,55,55,55,55,55,55,55,55,55,55,55,55,55,55,55,55,55,55,55,55,55,55,55,55,55,55,55,55,55,55,55,55,55,55,90,91,16,46,46,46,46,46,46,46,46,60,2,55,22,10,55,55,55,182,55,10,10,10,10,10,10,21,55,55,55,55,0,61,46,46,47,55,55,55,55,55,55
55,55,55,55,55,55,55,55,55,55,55,55,55,55,55,55,55,55,55,55,55,55,55,55,55,55,55,55,55,55,55,137,55,55,55,55,55,55,55,90,91,16,46,46,46,46,46,46,46,60,1,2,55,55,55,55,55,55,55,55,55,55,55,55,55,0,1,2,0,61,46,140,15,92,55,55,55,135,55,55
55,55,55,55,55,55,55,55,0,1,1,1,2,55,55,55,55,55,55,55,55,55,55,55,55,55,55,55,55,55,55,55,55,180,135,55,55,55,55,55,55,45,184,46,46,46,46,46,46,46,46,60,1,2,55,55,55,55,55,55,55,0,1,1,2,45,46,47,45,46,46,15,92,55,55,55,55,55,55,55
