46,15,16,46,46,46,46,46,46,46,46,46,46,46,46,46,46,46,46,46,46,46,46,46,46,46,46,46,46,46,46,46,46,46,46,46,46,46,46,46,46,46,46,46,46,46,46,46,46,46,46,46,46,46,46,46,46,46,46,46,46,46,46,46,46,46,46,46,46,46,46,46,46,46,46,46,46,47,0,61
46,60,61,46,46,46,46,46,46,46,46,46,46,46,46,46,46,46,46,46,46,46,46,46,46,46,46,46,46,46,46,46,46,46,46,46,46,46,46,46,46,46,46,46,46,46,46,46,46,46,46,46,46,46,46,46,46,46,46,46,46,46,46,46,46,46,46,46,46,46,46,46,46,46,46,46,46,47,45,46
46,46,46,46,46,46,46,46,46,46,46,46,46,46,46,46,46,46,46,46,46,46,46,46,46,46,46,46,46,46,46,46,46,46,46,46,46,46,46,46,46,46,46,46,46,46,46,46,46,46,46,46,46,46,46,46,46,46,46,46,46,46,46,46,46,46,46,46,46,46,46,46,46,139,46,46,46,47,45,140
46,46,46,46,46,46,46,46,46,46,46,46,46,46,46,46,46,46,46,46,46,46,46,46,46,46,46,46,46,46,46,46,46,46,46,46,46,46,46,46,46,46,46,46,46,46,46,46,46,46,46,46,46,46,46,46,46,46,46,46,46,46,46,46,46,46,46,46,46,46,46,46,46,46,46,46,15,92,45,15
46,46,46,46,46,46,46,46,46,46,46,46,46,46,46,46,46,46,46,46,46,46,46,46,46,46,46,46,46,46,46,46,46,46,46,46,46,46,46,46,46,46,46,46,46,46,46,46,46,46,46,46,46,46,46,46,46,46,46,46,46,46,46,46,46,46,46,46,46,46,46,46,46,46,46,15,92,0,61,47
46,46,46,46,46,46,46,46,46,46,46,46,46,46,46,46,46,46,46,46,46,46,46,46,46,46,46,46,46,46,46,46,46,46,46,46,46,46,46,46,46,46,46,46,46,46,46,46,46,46,46,46,46,46,46,46,46,46,46,46,46,46,46,46,46,46,46,46,46,46,138,46,46,15,91,92,0,61,15,92
46,46,46,46,46,46,46,46,46,46,46,46,46,46,46,46,46,46,46,46,46,46,46,46,46,46,46,46,46,46,46,46,46,46,46,46,46,46,46,46,46,46,46,46,46,46,46,46,46,46,46,46,46,46,46,46,46,46,46,46,46,46,46,46,46,46,46,46,46,46,138,46,140,60,1,1,61,15,92,55
46,46,46,46,46,46,46,46,46,46,46,46,46,46,46,46,46,46,46,46,46,46,46,46,46,46,46,46,46,46,46,46,46,46,46,46,46,46,46,46,46,46,46,46,46,46,46,46,46,46,46,46,46,46,46,46,139,46,46,46,46,46,46,46,185,46,184,46,183,184,46,46,46,46,46,46,46,47,55,55
46,46,46,46,46,46,46,46,46,46,46,46,46,46,46,46,46,46,46,46,46,46,46,46,46,46,46,46,46,46,46,46,46,46,46,46,46,46,46,46,46,46,46,46,46,46,46,46,46,46,46,46,46,46,46,46,46,46,46,46,15,91,16,46,46,46,46,46,46,46,46,46,46,46,15,91,91,92,55,55
46,46,46,46,46,46,46,46,46,46,46,46,46,46,46,46,46,46,139,185,46,15,16,46,46,46,46,46,46,46,46,46,46,46,46,183,184,46,46,46,46,46,46,46,46,46,184,139,46,46,46,46,46,46,46,46,15,91,91,91,92,0,61,46,46,46,46,46,46,46,46,46,46,15,92,55,55,55,55,55
46,46,46,15,16,46,183,183,139,46,15,91,16,46,46,46,46,46,46,46,46,60,61,184,138,46,46,138,183,140,46,46,46,46,46,46,46,46,46,46,46,139,46,46,46,46,46,184,183,185,46,46,46,46,46,46,60,1,1,1,1,61,46,46,15,91,91,16,46,15,91,91,91,92,181,136,55,55,55,55
46,46,46,60,61,140,46,46,15,91,92,55,90,91,91,91,91,91,91,91,91,91,91,91,16,46,46,46,46,46,46,46,46,46,139,15,91,91,91,91,16,46,46,46,46,46,46,46,46,46,46,15,91,91,16,46,46,46,185,184,46,46,15,91,92,55,55,90,91,92,55,55,55,55,55,55,55,55,55,55
138,46,46,46,46,46,15,91,92,55,55,55,55,55,55,55,55,55,55,55,55,55,55,55,90,16,46,46,46,15,91,91,91,91,91,92,55,55,55,55,90,91,91,91,91,91,91,91,91,91,91,92,55,55,90,91,91,91,91,91,91,91,92,55,55,55,55,55,55,55,55,55,55,55,55,55,55,55,55,55
46,46,15,91,91,91,92,55,181,55,55,180,55,55,55,55,55,55,55,55,55,55,55,55,55,90,91,91,91,92,55,55,55,55,55,181,55,55,55,55,55,55,55,55,55,55,55,55,55,55,55,55,55,55,55,55,55,55,55,55,55,55,55,55,55,55,55,55,55,55,55,55,55,55,55,55,55,55,135,55
46,15,92,55,55,55,55,55,182,55,55,55,55,55,55,55,55,55,137,55,55,55,136,55,55,55,55,55,55,55,55,55,55,55,55,55,55,55,55,55,55,55,55,55,55,55,55,180,55,55,55,55,55,55,55,55,55,55,55,55,55,55,55,55,55,55,55,55,181,55,55,55,55,136,55,55,55,55,55,55
91,92,55,55,55,55,55,55,55,55,180,55,55,55,55,55,55,55,55,55,55,55,55,55,55,55,55,55,55,55,55,55,55,136,55,55,55,55,55,180,182,55,55,55,55,55,55,55,55,55,55,55,55,55,55,55,55,55,55,55,55,55,55,55,181,55,55,55,55,55,55,55,55,55,55,55,55,55,55,55
55,55,55,55,136,55,135,55,55,55,55,180,55,55,135,55,55,55,55,55,55,55,55,135,55,55,55,55,55,55,55,55,55,55,55,55,55,55,55,55,55,55,55,55,55,55,182,55,55,55,55,55,55,55,55,55,137,55,55,135,55,55,55,55,55,55,55,55,55,55,55,55,55,55,55,55,55,55,55,55
55,55,55,136,55,55,55,55,55,55,55,181,55,55,182,55,55,55,55,55,55,55,55,55,55,55,55,55,55,55,55,55,55,55,55,55,55,55,55,55,55,55,55,55,55,55,55,55,135,55,55,55,55,55,55,55,55,55,55,136,55,55,55,55,55,55,55,55,55,55,55,55,55,55,55,55,182,55,55,55
55,55,55,182,55,55,55,55,55,55,55,55,55,55,55,55,55,55,136,55,55,55,55,55,55,55,55,55,55,55,55,55,55,55,55,55,55,55,55,55,55,55,55,55,55,181,55,55,55,55,55,55,55,55,55,55,55,55,55,55,55,55,55,55,55,55,55,55,55,55,55,55,55,55,55,55,55,55,55,55
55,182,182,55,55,55,55,55,55,55,55,55,55,55,55,55,55,55,55,55,55,55,55,55,55,55,55,55,55,55,55,55,55,55,55,55,55,55,55,135,55,55,55,55,55,55,55,55,55,55,55,55,55,135,181,55,55,55,55,55,55,55,55,55,55,55,55,55,180,55,55,181,55,55,55,55,55,55,55,180
55,55,55,55,135,135,136,55,55,55,180,55,55,55,55,55,181,55,55,55,55,55,55,55,55,55,55,55,55,55,55,55,55,55,55,55,55,55,55,55,55,55,55,55,55,55,55,55,182,55,55,55,55,55,55,55,55,55,55,55,55,55,55,55,55,55,55,55,55,55,55,55,55,55,55,55,55,55,55,55
55,55,55,55,55,55,55,55,55,55,55,55,55,55,55,55,55,55,55,55,55,55,55,55,55,55,55,55,55,55,55,55,55,55,55,55,55,55,55,55,55,55,55,137,55,55,55,55,55,55,55,55,55,55,55,55,55,55,55,55,55,55,55,55,135,55,55,55,55,55,55,55,55,55,55,55,55,55,55,55
55,55,55,55,55,55,55,55,55,55,55,55,55,136,55,55,55,180,55,55,55,55,55,55,55,55,55,55,55,182,136,55,55,55,55,55,55,55,55,55,55,55,136,55,55,55,55,55,55,55,55,55,55,55,55,55,55,55,55,55,55,55,55,55,55,55,55,135,55,55,55,55,55,55,55,55,55,55,55,55
55,55,55,55,55,55,55,55,55,55,181,55,55,55,55,180,55,55,55,55,55,55,55,55,55,136,55,55,55,55,55,55,55,55,55,55,55,55,55,55,55,55,55,55,55,182,182,55,55,55,55,55,55,55,137,55,55,55,55,182,55,55,55,55,55,55,55,55,55,55,55,55,55,55,55,55,55,55,55,55
55,135,55,55,180,55,55,55,55,55,180,55,55,55,55,55,55,55,55,55,55,55,55,55,0,1,1,1,1,2,55,55,55,55,55,55,55,55,55,55,55,55,55,55,55,55,55,55,55,55,55,55,55,55,55,55,55,55,55,55,55,55,55,55,55,55,55,55,55,55,55,55,55,55,55,55,55,55,55,55
55,55,55,55,55,55,55,55,55,55,55,55,55,55,55,55,55,55,55,55,55,136,55,0,61,46,46,46,46,47,55,0,1,1,1,1,2,55,55,55,55,55,55,55,55,55,55,55,55,55,55,55,55,55,55,55,55,55,55,55,55,55,55,55,55,55,55,55,55,135,55,55,55,55,55,55,55,55,55,55
55,55,55,55,55,55,55,55,55,55,55,55,55,55,55,55,55,55,55,55,55,55,55,61,46,46,46,46,46,60,1,61,46,184,140,46,60,2,55,137,55,55,55,55,55,55,55,55,55,55,55,55,55,55,55,55,55,55,55,55,55,55,55,55,55,55,55,55,135,55,55,55,55,55,55,181,55,55,55,55
55,55,55,181,55,55,55,55,55,55,55,55,55,55,55,55,55,55,180,0,1,1,1,46,46,46,46,46,46,46,46,46,46,138,46,139,46,47,55,55,55,55,55,55,55,55,55,55,55,55,55,55,55,55,55,55,55,55,55,55,55,55,55,55,136,55,55,55,55,55,55,55,55,55,55,55,55,55,55,55
181,55,55,55,55,55,55,55,55,55,55,55,55,55,55,55,136,55,55,45,46,46,46,46,46,46,46,15,91,91,16,46,46,46,46,183,183,60,2,55,55,135,55,55,0,1,1,2,55,55,55,182,55,55,136,55,55,55,55,55,55,180,55,55,55,55,55,55,55,55,55,55,55,55,55,55,55,55,55,55
55,55,55,55,55,55,55,55,55,55,55,55,55,55,55,55,55,55,55,45,46,46,46,46,46,15,16,60,1,1,61,46,46,46,46,46,139,46,60,2,55,55,55,55,55,46,46,47,55,55,55,55,55,55,55,55,55,55,55,55,55,55,55,55,55,55,55,55,55,55,55,55,55,55,55,55,55,55,55,55
55,55,55,55,55,55,55,55,55,55,55,55,55,55,55,55,55,55,55,45,46,46,46,46,46,60,61,46,46,46,46,46,46,46,46,46,184,46,46,47,55,55,55,55,55,16,46,60,2,55,182,55,55,55,55,55,180,55,55,55,55,55,55,55,55,55,55,55,55,55,55,55,55,55,55,55,55,280,280,280
55,55,55,55,55,55,55,55,55,55,55,55,55,55,55,0,1,1,61,46,46,46,46,46,46,46,46,46,46,46,46,46,46,46,46,46,15,16,46,47,55,55,55,181,55,90,16,185,47,55,55,55,136,55,55,55,55,55,55,55,55,55,55,55,55,55,181,55,55,55,55,55,55,55,55,55,280,280,280,280
55,55,55,55,55,55,55,55,55,55,55,55,55,55,0,61,46,46,46,46,46,46,46,46,46,46,46,46,46,46,46,46,46,46,46,46,60,61,139,47,55,55,55,55,1,1,61,185,60,2,55,55,55,55,55,55,55,55,55,55,55,55,55,55,55,55,55,55,55,55,55,55,55,55,55,55,280,280,280,280
55,55,55,55,55,55,55,55,55,55,55,55,55,0,61,46,46,46,46,46,46,46,46,46,46,46,46,46,46,46,46,46,46,46,46,46,46,46,138,47,55,137,55,55,46,46,46,46,46,47,55,55,182,181,55,55,55,55,55,55,55,55,55,55,55,55,55,55,55,181,55,55,55,55,55,55,280,280,280,280
55,136,55,55,55,55,55,55,55,55,55,55,0,61,46,46,46,46,46,46,46,46,46,46,46,46,46,46,46,46,46,46,46,46,46,46,46,46,46,47,55,55,55,55,46,46,46,183,139,60,2,55,55,55,55,55,55,55,55,55,55,135,55,55,55,55,55,55,55,55,55,55,55,55,55,55,280,280,280,280
55,55,55,55,55,55,55,55,55,55,55,55,45,46,46,46,46,46,46,46,46,46,46,46,46,46,46,46,46,46,46,46,46,15,91,16,184,46,46,47,55,55,55,45,46,46,46,46,46,46,47,55,55,55,55,55,55,55,55,55,55,55,55,55,55,55,55,55,55,55,55,55,55,55,55,280,280,280,280,280
55,55,55,55,55,55,55,55,55,55,55,55,45,46,15,16,46,46,46,46,46,46,46,46,46,46,46,46,46,46,46,46,46,60,1,61,46,46,15,92,55,55,55,61,46,46,46,15,16,46,60,2,55,55,55,55,55,55,55,55,55,55,55,55,55,55,55,136,55,55,55,55,55,55,55,280,280,280,280,280
55,55,55,55,0,1,55,55,55,55,55,0,61,46,60,61,46,46,46,46,46,46,46,46,46,46,46,46,46,46,46,46,46,46,46,138,46,15,92,55,180,55,55,46,46,46,46,60,61,46,46,47,55,55,55,55,55,55,55,55,55,55,55,55,55,55,55,55,55,55,55,55,55,55,55,280,280,280,280,280
55,55,55,55,45,55,55,55,55,181,55,45,46,46,46,46,46,46,46,46,46,46,46,46,46,46,46,46,46,46,46,183,46,46,46,15,91,92,55,55,55,55,46,46,46,46,185,46,46,46,46,47,55,55,136,55,55,55,55,55,55,55,55,55,55,55,55,55,55,55,55,55,55,55,55,280,280,280,280,280
55,55,55,0,55,55,55,180,55,55,55,45,46,46,46,46,46,46,46,46,46,46,46,46,46,46,46,46,46,46,46,46,15,91,91,92,181,55,180,55,55,46,46,46,46,46,184,138,46,46,46,47,55,55,55,182,55,55,55,55,55,55,55,55,55,55,55,55,55,135,55,55,55,55,55,280,280,280,280,280
55,55,55,45,55,55,180,55,55,55,0,61,46,46,46,46,46,46,46,46,46,46,46,46,46,46,46,15,16,183,140,46,47,55,55,55,55,55,55,55,46,46,46,46,46,46,46,184,140,46,15,92,55,55,55,55,55,55,55,55,55,135,55,55,55,55,55,55,55,55,55,55,55,55,55,280,280,280,280,280
55,0,1,55,55,181,55,55,55,55,45,46,46,46,46,46,46,46,46,46,46,46,46,46,46,46,138,47,45,185,46,15,92,55,135,55,55,55,55,46,46,46,46,46,46,46,46,140,184,15,92,55,55,55,55,55,55,55,55,55,55,55,55,55,55,55,55,55,55,55,55,55,55,55,55,55,280,280,280,280
0,61,46,55,55,55,55,55,55,55,45,46,46,46,46,46,46,46,46,46,46,46,46,46,46,139,46,60,61,46,15,92,55,55,55,55,46,46,46,46,46,46,46,46,46,46,183,185,46,47,55,55,55,55,55,55,55,55,55,55,55,55,55,55,55,55,55,55,55,55,55,55,55,55,55,55,280,280,280,280
61,46,46,55,55,55,55,55,0,1,61,46,46,46,46,46,46,46,46,46,46,46,46,46,46,185,46,139,15,91,92,135,55,55,45,46,46,46,46,46,46,46,46,46,46,138,184,46,15,92,55,55,55,55,55,55,55,55,55,135,55,55,55,55,55,55,55,55,55,55,55,55,55,55,55,55,280,280,280,280
46,46,55,55,55,55,55,0,61,46,46,46,46,46,46,46,46,46,46,46,46,46,46,46,15,91,91,91,92,55,55,55,55,0,61,46,46,46,46,46,46,46,183,46,138,46,46,46,47,55,55,55,55,55,55,55,55,55,55,55,55,55,55,55,55,55,55,55,55,55,55,55,55,55,55,55,280,280,280,280
46,55,55,55,55,0,1,61,46,46,46,46,46,46,46,46,46,46,46,46,15,91,91,91,92,55,55,55,55,55,55,55,55,45,46,46,46,46,46,46,46,46,46,139,46,46,46,46,47,55,55,55,55,55,55,55,55,55,55,55,55,55,55,55,55,55,55,182,55,55,55,182,182,55,55,55,55,280,280,280
55,55,55,55,0,61,46,46,46,46,46,46,46,46,46,46,15,91,91,91,92,137,55,55,55,135,55,55,55,55,55,55,55,45,46,46,46,46,46,46,46,46,46,183,46,46,46,46,47,55,55,55,55,55,55,55,55,55,55,55,55,55,55,55,55,55,55,55,55,55,55,55,55,55,55,55,55,280,280,280
55,55,55,0,61,46,46,46,46,46,46,46,15,91,91,91,92,55,55,55,55,55,182,55,55,55,55,55,55,55,55,55,55,45,46,46,46,46,46,46,46,46,15,91,91,16,46,15,92,55,55,55,55,55,55,55,55,181,182,55,55,55,55,55,55,55,55,55,55,55,55,55,55,55,55,55,55,280,280,280
55,55,0,61,46,46,46,46,46,46,46,15,92,55,55,55,55,55,137,55,55,55,55,55,55,55,55,55,55,55,55,55,55,45,46,46,46,46,184,46,46,46,60,1,1,61,15,92,55,55,55,55,55,55,55,55,55,180,55,55,55,55,135,55,55,55,55,55,136,182,55,55,55,55,55,55,55,280,280,280
55,0,61,46,46,46,46,46,46,46,15,92,55,55,182,55,55,55,55,55,55,55,55,55,55,55,55,55,55,55,55,0,1,61,46,46,46,15,91,16,46,46,46,46,15,91,92,55,55,55,55,55,55,55,55,55,55,55,55,55,55,55,135,55,55,55,55,55,55,55,55,55,55,137,55,55,55,280,280,280
1,61,46,46,46,46,46,46,15,91,92,55,21,55,55,55,55,55,55,55,55,55,55,55,55,55,55,55,55,55,0,61,46,46,46,15,91,92,0,61,46,15,91,91,92,55,55,55,55,55,55,55,55,55,55,55,55,55,180,55,55,55,137,55,55,55,55,55,55,55,55,55,55,55,55,55,55,280,280,280
46,46,46,46,139,46,15,91,92,55,10,21,55,55,55,55,55,55,55,55,55,55,55,55,55,55,55,55,0,1,61,46,46,15,91,92,0,1,61,46,15,92,55,55,55,55,55,55,55,55,55,55,55,55,55,55,55,55,55,180,55,55,55,55,55,55,55,55,55,55,55,55,55,55,55,55,55,280,280,280
46,46,46,15,91,91,92,55,55,21,55,55,55,55,55,55,55,55,55,55,55,55,55,55,55,55,0,1,61,46,183,46,46,60,1,1,61,46,46,15,92,55,55,55,55,55,55,55,55,55,55,55,181,55,55,55,55,181,55,55,55,55,55,55,55,55,55,182,55,55,55,55,55,181,55,55,55,280,280,280
46,46,15,92,55,55,55,55,55,55,55,55,55,55,55,55,55,55,55,55,55,55,55,55,0,1,61,46,46,15,91,16,46,46,46,46,46,15,91,92,55,55,55,55,55,55,55,55,55,55,55,55,55,55,55,55,55,55,55,55,55,55,55,55,55,55,55,180,55,181,55,55,55,135,55,55,280,280,280,280
46,15,92,55,55,55,55,55,55,55,55,55,55,55,55,55,55,55,55,55,55,55,55,55,45,46,46,46,46,60,1,61,46,15,91,91,91,92,55,55,55,55,55,55,55,55,55,55,55,55,180,55,55,55,55,55,55,55,55,55,55,55,55,55,55,55,55,136,55,55,55,55,55,55,55,55,280,280,280,280
15,92,55,55,55,55,55,55,55,55,55,55,55,55,55,55,55,55,55,55,55,0,1,1,61,46,46,46,46,46,46,46,15,92,55,55,55,55,55,55,55,55,55,55,55,55,55,55,55,55,55,182,55,55,55,55,55,55,55,55,55,55,55,55,55,55,55,55,55,55,55,180,55,55,55,55,280,280,280,280
92,55,55,55,55,55,55,55,55,55,55,55,55,55,0,1,1,1,1,1,1,61,46,46,46,46,46,46,15,91,91,91,92,55,55,55,55,55,55,55,55,55,55,55,55,55,55,55,55,55,55,55,55,55,55,55,55,55,55,55,55,55,55,55,55,55,55,55,55,55,55,136,55,55,55,55,280,280,280,280
55,55,55,55,55,55,55,55,55,55,55,55,0,1,61,46,46,185,139,46,46,46,46,15,91,91,91,91,92,55,55,55,55,55,55,55,55,55,55,55,55,55,55,55,55,55,55,55,55,55,55,55,55,55,55,55,55,55,55,55,55,55,55,55,55,55,55,55,55,181,55,55,55,55,55,55,280,280,280,280
181,55,55,55,55,55,55,55,55,55,0,1,61,46,46,46,15,91,91,91,91,91,91,92,55,55,55,55,55,55,55,55,55,55,55,55,55,55,55,55,55,55,55,55,55,55,55,55,55,55,135,55,55,55,55,55,55,55,55,55,55,55,55,55,55,55,55,55,55,55,55,55,55,55,55,280,280,280,280,280
55,55,55,55,55,55,55,0,1,1,61,46,46,185,15,91,92,55,55,55,55,55,55,55,55,55,55,55,55,55,55,55,136,55,181,55,55,55,55,55,55,55,55,182,55,55,55,55,55,55,136,55,55,55,55,55,55,55,55,55,55,55,55,55,55,55,55,135,55,55,55,55,55,55,55,280,280,280,280,280
55,55,55,55,55,55,0,61,46,183,46,46,15,91,92,55,55,55,55,55,55,55,55,55,55,55,55,55,55,55,55,55,55,55,55,55,55,55,55,55,55,55,55,55,55,55,55,55,55,55,55,55,55,55,55,55,55,55,55,55,55,55,55,55,55,55,55,55,55,55,55,55,55,55,55,280,280,280,280,280
55,55,55,55,55,55,45,46,46,15,91,91,92,55,55,55,55,55,55,55,55,55,55,55,55,55,55,55,55,55,55,55,55,55,55,55,55,55,55,55,55,55,55,55,55,55,55,55,55,55,55,55,55,55,55,55,137,55,55,55,55,55,55,55,55,55,55,55,55,55,55,55,55,55,280,280,280,280,280,280
55,55,55,55,55,0,61,46,15,92,55,55,55,55,55,55,55,55,55,55,55,55,55,55,55,55,55,55,55,55,55,55,181,55,55,55,55,55,55,55,55,55,55,55,55,55,55,55,55,55,55,55,55,55,55,55,55,55,55,55,55,55,55,55,55,55,55,55,55,55,55,55,55,55,280,280,280,280,280,280
55,55,55,55,0,61,46,46,47,55,55,55,55,55,55,55,55,55,55,55,55,55,55,55,55,55,55,55,55,55,55,55,55,55,55,55,55,55,55,55,55,55,55,55,55,55,55,55,55,55,55,55,55,55,55,55,55,55,55,55,55,55,55,55,55,55,55,55,55,55,55,55,55,280,280,280,280,280,280,280
55,55,55,0,61,184,46,15,92,55,55,55,55,55,55,55,55,55,55,55,55,55,55,180,55,55,55,55,55,55,55,55,55,55,55,55,55,55,280,280,280,280,280,280,55,55,55,55,55,55,55,55,55,55,55,55,55,55,55,55,55,55,55,55,55,55,55,55,55,55,55,55,280,280,280,280,280,280,280,280
55,55,55,45,46,46,15,92,55,55,55,55,55,55,55,55,55,55,55,55,182,55,55,55,55,55,55,55,55,55,55,55,55,55,55,55,280,280,280,280,280,280,280,280,280,55,55,55,55,55,55,55,55,55,55,55,55,55,55,55,55,55,55,55,55,55,55,55,55,55,55,55,280,280,280,280,280,280,225,226
55,55,0,61,46,15,92,55,55,55,55,55,55,55,55,55,55,55,55,55,55,55,55,55,55,55,55,55,55,55,55,55,55,55,55,280,225,226,226,226,226,226,227,280,280,280,280,280,55,55,55,55,55,55,55,55,55,55,55,55,55,55,55,55,55,55,55,55,55,55,55,280,280,280,280,280,280,225,286,271
55,0,61,140,46,47,55,55,55,55,55,55,55,55,55,55,55,136,55,55,55,55,55,55,55,55,55,55,55,280,280,280,280,280,225,226,286,271,271,271,271,271,285,227,280,280,280,280,280,55,55,55,55,55,55,55,55,55,55,55,55,55,55,55,55,55,55,55,55,55,280,280,280,280,225,226,226,286,271,271
1,61,140,138,15,92,55,55,55,55,55,55,55,55,55,55,55,55,55,55,55,55,55,55,55,280,280,280,280,280,280,280,225,226,286,271,271,271,271,271,271,271,271,285,226,227,280,280,280,55,55,55,55,55,55,55,55,55,55,55,55,55,55,55,55,55,55,55,55,280,280,280,225,226,286,271,271,271,271,271
183,184,46,15,92,55,55,55,55,55,55,55,55,55,55,55,55,55,55,55,55,55,55,55,280,280,280,225,226,226,227,225,286,271,271,271,271,271,271,271,271,271,271,271,271,285,227,280,280,280,55,55,55,55,55,55,55,55,55,55,55,55,55,55,55,55,55,55,280,225,226,226,286,271,271,271,271,271,271,271
15,91,91,92,55,55,55,55,55,55,55,55,55,55,55,55,55,55,55,55,55,55,280,280,280,280,225,286,271,271,285,286,271,271,271,271,271,271,271,271,271,271,271,271,271,271,285,227,280,280,55,55,55,55,55,55,55,55,55,55,55,55,55,55,280,280,280,280,225,286,271,271,240,241,271,271,271,271,271,271
92,55,55,55,55,55,55,55,55,55,55,55,55,55,55,55,55,55,55,55,55,225,226,226,226,226,286,271,271,271,271,271,271,271,271,271,271,271,271,271,271,271,271,271,271,271,271,285,227,280,280,280,280,280,280,280,280,280,361,362,406,280,280,280,280,280,280,280,270,271,271,271,272,270,271,271,271,271,271,271
55,55,55,55,55,55,55,55,55,55,55,55,55,55,55,55,55,55,55,280,280,270,271,271,271,271,271,271,271,271,271,271,271,271,271,271,271,271,271,271,271,271,271,271,271,271,271,271,285,227,280,280,280,280,280,280,362,280,280,361,280,280,280,280,280,280,280,225,286,271,271,271,285,286,271,271,271,271,271,271
55,55,55,55,55,55,55,182,55,55,55,182,55,55,55,55,55,280,280,280,225,286,271,271,271,271,271,271,271,271,271,271,271,271,271,271,271,271,271,271,271,271,271,271,271,363,271,271,365,285,227,280,280,280,280,280,360,280,280,280,280,280,280,280,280,280,280,270,271,271,271,271,271,271,271,271,271,271,409,271
55,55,55,55,55,55,55,55,55,55,55,55,55,55,55,55,280,280,280,225,286,271,271,271,271,240,241,271,271,271,271,271,271,271,271,271,271,271,271,271,271,271,271,271,271,271,271,271,363,271,272,280,280,280,280,280,361,280,280,280,280,280,280,280,280,280,280,270,271,271,271,271,271,271,271,271,271,410,365,271
55,55,55,55,55,55,55,55,137,55,55,55,55,55,55,280,280,280,225,286,271,240,241,271,271,285,286,271,271,271,271,271,271,271,271,271,271,271,271,271,271,271,271,271,271,271,409,410,271,364,272,280,280,280,280,280,361,280,280,280,280,280,407,361,405,280,225,286,271,271,271,271,271,271,240,316,241,365,271,271
181,55,55,55,55,55,55,55,55,55,55,55,55,55,280,280,280,280,270,271,271,285,286,271,271,271,271,271,271,271,271,271,271,271,271,271,271,271,271,271,271,271,271,271,271,271,271,271,271,240,317,280,280,280,280,362,361,280,280,280,280,407,360,280,280,280,270,271,271,271,271,271,271,271,285,226,286,271,271,271
55,55,55,55,55,55,136,55,55,55,55,55,55,280,280,280,280,225,286,271,271,271,271,271,271,271,271,271,271,271,271,271,271,271,271,271,271,271,271,271,271,271,271,271,271,271,271,271,271,272,280,280,280,280,406,280,406,280,280,280,280,280,280,280,280,225,286,271,271,271,271,271,271,271,271,271,271,271,271,271
55,55,55,55,55,55,55,55,55,55,55,55,280,280,225,226,226,286,271,271,271,271,271,271,271,271,271,271,271,271,271,271,271,271,271,271,271,271,271,271,271,271,271,271,271,271,271,271,271,272,280,280,280,362,280,280,280,405,280,405,280,280,280,280,225,286,271,271,271,271,271,271,271,271,271,271,271,240,316,316
55,55,55,55,137,55,55,55,55,55,55,55,280,225,286,271,271,271,271,271,271,271,271,271,271,271,271,271,271,271,271,271,271,240,241,271,271,271,271,271,271,271,271,271,271,271,271,271,271,272,280,362,406,280,280,280,280,280,280,405,280,280,280,225,286,271,271,271,271,271,271,271,271,271,271,271,240,317,280,280
