280,280,280,280,280,280,280,280,280,280,280,280,280,280,280,280,280,280,280,280,280,280,280,280,280,280,280,280,280,280,280,280,280,280,280,280,280,280,280,280,280,280,280,280,280,280,280,280,280,280,280,280,280,280,280,280,280,280,280,280,280,280,280,280,280,280,280,280,280,280,280,280,280,280,280,280,280,280,280,280
280,280,280,280,280,280,280,280,280,280,280,280,280,280,280,280,280,280,280,280,280,280,280,280,280,280,280,280,280,280,280,280,280,280,280,280,280,280,280,280,280,280,280,280,280,280,280,280,280,280,280,280,280,280,280,280,280,280,280,280,280,280,280,280,280,280,280,280,280,280,280,280,280,280,280,280,280,280,280,280
280,280,280,280,280,280,280,280,280,280,280,280,280,280,280,280,280,280,280,280,280,280,280,280,280,280,280,280,280,280,280,280,280,280,280,280,280,280,280,280,280,280,280,280,280,280,280,280,280,280,280,280,280,280,280,280,280,280,280,280,280,280,280,280,280,280,280,280,280,280,280,280,280,280,280,280,280,280,280,280
280,280,280,280,280,280,280,280,280,280,280,280,280,280,280,280,280,280,280,280,280,280,280,280,280,280,280,280,280,280,280,280,280,280,280,280,280,280,280,280,280,280,280,280,280,280,280,280,280,280,280,280,280,280,280,280,280,280,280,280,280,280,280,280,280,280,280,280,280,280,280,280,280,280,280,280,280,280,280,280
280,280,280,280,280,280,280,280,280,280,280,280,280,280,280,280,280,280,280,280,280,280,280,280,280,280,280,280,280,280,280,280,280,280,280,280,280,280,280,280,280,280,280,280,280,280,280,280,280,280,280,280,280,280,280,280,280,280,280,280,280,280,280,280,280,280,280,280,280,280,280,280,280,280,280,280,280,280,280,280
280,280,280,280,280,280,280,280,280,280,280,280,280,280,280,280,280,280,280,280,280,280,280,280,280,280,280,280,280,280,280,280,280,280,280,280,280,280,280,280,280,280,280,280,280,280,280,280,280,280,280,280,280,280,280,280,280,280,280,280,280,280,280,280,280,280,280,280,280,280,280,280,280,280,280,280,280,280,280,280
280,280,280,280,280,280,280,280,280,280,280,280,280,280,280,280,280,280,280,280,280,280,280,280,280,280,280,280,280,280,280,280,280,280,280,280,280,280,280,280,280,280,280,280,280,280,280,280,280,280,280,280,280,280,280,280,280,280,280,280,280,280,280,280,280,280,280,280,280,280,280,280,280,280,280,280,280,280,280,280
280,280,280,280,280,280,280,280,280,280,280,280,280,280,280,280,280,280,280,280,280,280,280,280,280,280,280,280,280,280,280,280,280,280,280,280,280,280,280,280,280,280,280,280,280,280,280,280,280,280,280,280,280,280,280,280,280,280,280,280,280,280,280,280,280,280,280,280,280,280,280,280,280,280,280,280,280,280,280,280
55,55,55,55,55,55,55,55,55,55,55,55,55,55,55,55,55,55,55,55,55,55,55,55,55,55,280,280,280,280,280,280,280,280,280,280,280,280,280,280,280,280,280,280,280,280,280,280,280,280,280,280,280,280,280,280,280,280,280,280,280,280,280,280,280,280,280,280,280,280,280,280,280,280,280,280,280,280,280,280
55,55,55,55,55,55,55,55,55,55,55,180,55,55,55,55,55,55,137,55,55,55,55,55,55,55,55,55,55,55,55,55,280,280,280,280,280,280,280,280,280,280,280,280,280,280,280,280,280,280,280,280,280,280,280,280,280,280,280,280,280,280,280,280,280,280,280,280,280,280,280,280,280,280,280,280,280,280,280,280
55,55,55,55,55,55,55,55,55,55,55,55,55,55,55,136,55,55,137,55,55,55,55,55,55,181,55,55,55,55,55,55,55,55,55,55,280,280,280,280,280,280,280,280,280,280,280,280,280,280,280,280,280,280,280,280,280,280,280,280,280,280,280,280,280,280,280,280,280,280,280,280,280,280,280,280,280,280,280,280
55,55,55,55,136,55,55,135,55,55,55,55,55,55,55,55,180,55,55,135,55,55,55,55,55,55,180,55,55,55,55,55,180,55,55,55,55,55,0,1,2,280,280,280,280,280,280,280,280,280,280,280,280,280,280,280,280,280,280,280,280,280,280,280,280,280,280,280,280,280,280,280,280,280,280,280,280,280,280,280
55,55,55,55,55,55,55,55,55,55,55,55,180,55,55,55,55,55,55,55,55,55,55,55,55,55,55,55,55,55,55,55,55,55,55,55,55,55,45,46,60,1,2,280,280,280,280,280,280,280,280,280,280,280,280,280,280,280,280,280,280,280,280,280,280,280,280,280,280,280,280,280,280,280,280,280,280,280,280,280
136,55,55,55,55,55,55,137,55,55,55,55,55,55,55,55,55,55,55,55,55,181,55,55,55,55,137,55,55,55,55,55,55,55,55,55,55,55,45,46,46,46,60,2,280,280,280,280,280,280,280,280,280,280,280,280,280,280,280,280,280,280,280,280,280,280,280,280,280,280,280,280,280,280,280,280,280,280,280,280
55,55,55,55,55,55,55,55,55,55,55,55,55,55,55,55,55,55,55,55,55,55,55,55,55,55,55,55,55,55,55,55,55,182,137,55,55,55,90,91,16,46,46,60,1,2,280,280,280,280,280,280,280,280,280,280,280,280,280,280,280,280,280,280,280,280,280,280,280,280,280,280,280,280,280,280,280,280,280,280
55,55,55,55,55,55,55,55,55,55,55,55,55,55,55,55,137,135,55,55,55,55,55,55,55,55,55,55,55,136,55,55,55,55,55,135,137,55,55,55,90,16,46,140,46,60,2,280,280,280,280,280,280,280,280,280,280,280,280,280,280,280,280,280,280,280,280,280,280,280,280,280,280,280,280,280,280,280,280,280
55,55,55,55,55,55,55,55,55,55,55,55,55,55,55,55,55,55,55,55,55,55,55,135,55,55,55,55,55,55,137,55,55,55,55,55,55,55,136,55,55,90,91,16,46,46,60,2,280,280,280,280,280,280,280,280,280,280,280,280,280,280,280,280,280,280,280,280,280,280,280,280,280,280,280,280,280,280,280,280
55,55,55,55,55,55,55,55,55,55,55,55,55,55,55,55,55,55,55,55,136,136,135,135,55,55,55,55,182,55,135,55,55,55,55,55,55,55,55,55,55,55,55,90,16,46,46,60,1,1,2,280,280,280,280,280,280,280,280,280,280,280,280,280,280,280,280,280,280,280,280,280,280,280,280,280,280,280,280,280
1,1,1,1,1,1,1,2,55,55,55,55,55,55,55,55,55,55,55,55,55,55,55,55,55,55,55,55,55,55,55,182,55,55,55,55,182,55,55,55,55,55,55,55,45,46,46,46,46,46,60,1,2,280,280,280,280,280,280,280,280,280,280,280,280,280,280,280,280,280,280,280,280,280,280,280,280,280,280,280
46,46,46,46,46,46,46,60,2,55,55,55,55,55,55,55,55,55,55,55,55,55,55,55,55,55,55,55,55,55,55,180,55,55,55,55,55,55,55,55,55,55,55,55,90,91,16,46,185,46,183,138,60,1,2,280,280,280,280,280,280,280,280,280,280,280,280,280,280,280,280,280,280,280,280,280,280,280,280,280
46,185,46,46,46,46,46,46,47,55,55,55,55,55,55,137,55,55,55,55,181,55,55,55,55,0,1,2,55,55,55,55,55,55,137,55,182,55,55,55,55,55,182,55,55,55,90,91,16,46,139,46,184,139,60,2,55,280,280,280,280,280,280,280,280,280,280,280,280,280,280,280,280,280,280,280,280,280,280,280
46,46,46,183,46,46,46,46,47,55,55,55,55,55,55,55,55,0,1,2,55,55,55,55,55,45,46,60,2,135,182,55,55,55,55,55,55,55,55,55,55,55,55,55,135,55,55,55,90,16,46,15,16,183,46,47,55,55,55,55,55,55,280,280,280,280,280,280,280,280,280,280,280,280,280,280,280,280,280,280
46,46,46,46,183,46,46,46,47,55,55,55,55,55,55,55,55,45,46,60,1,2,55,55,55,45,185,46,60,2,55,55,55,55,55,55,55,55,55,55,55,137,55,55,55,55,55,55,55,90,91,92,90,91,91,92,55,55,55,55,55,55,55,55,55,55,55,55,55,55,55,55,55,55,55,55,55,55,55,55
46,46,46,46,140,46,46,46,47,55,55,137,55,55,135,55,55,45,46,46,46,47,55,0,1,61,46,46,46,60,2,55,55,55,55,55,55,55,136,135,55,55,55,55,55,55,55,55,55,55,55,55,55,55,55,55,55,55,55,55,55,55,55,55,55,55,55,55,55,55,55,55,55,55,55,55,55,55,55,55
46,46,46,46,46,46,46,46,47,55,55,55,135,55,55,55,55,90,16,46,15,92,0,61,46,46,138,185,46,46,47,55,55,55,55,55,55,55,55,135,55,182,55,55,55,55,55,55,55,55,55,55,55,55,55,55,55,135,55,55,55,55,55,55,55,55,55,55,55,55,55,55,55,55,55,55,55,55,55,55
46,46,46,46,46,46,46,46,47,55,55,55,55,55,55,55,55,55,45,46,60,2,45,46,46,46,46,46,46,46,60,2,55,55,55,55,55,55,55,55,55,180,55,55,55,55,55,55,182,55,55,55,55,55,55,55,55,55,55,55,55,55,55,55,55,55,55,137,135,55,55,55,182,55,55,55,55,182,55,55
46,46,46,46,46,138,46,46,47,55,55,55,55,55,55,55,55,55,90,16,46,47,45,46,46,46,46,140,46,46,46,60,1,1,1,2,55,55,55,55,55,55,55,55,55,55,55,136,55,55,55,55,182,55,55,55,55,55,55,55,55,55,181,55,55,55,55,182,55,55,55,55,55,55,55,55,55,55,55,137
46,46,46,46,46,138,46,15,92,55,55,55,55,55,55,55,55,55,55,90,91,92,45,46,46,46,46,184,46,184,46,46,46,46,46,60,2,55,55,55,55,55,55,55,55,55,55,55,55,55,55,182,55,55,55,55,55,55,135,55,55,55,180,55,55,55,55,55,55,182,55,55,55,55,55,55,55,55,55,55
46,138,46,46,46,46,15,92,55,55,182,137,55,55,55,55,55,55,55,55,55,55,45,46,46,46,46,46,46,46,184,46,46,46,46,46,47,55,55,55,55,55,55,55,180,55,55,55,55,55,55,181,55,55,55,180,55,55,55,55,55,55,55,55,55,55,55,55,55,55,55,181,55,55,55,55,55,55,135,55
46,46,46,46,46,46,47,55,55,55,55,55,55,55,180,182,55,55,55,55,55,0,61,46,46,46,46,46,46,46,46,46,46,46,46,46,60,2,55,55,55,55,136,55,55,135,55,55,55,136,55,55,182,55,55,55,55,55,55,55,55,55,55,55,55,55,55,55,55,55,55,55,55,55,136,55,55,55,55,55
46,46,46,46,46,46,47,55,55,55,55,182,55,55,135,55,181,55,55,55,0,61,46,46,46,46,46,46,46,46,46,46,46,46,46,46,46,47,55,55,55,55,55,55,137,181,55,55,55,55,55,55,55,55,55,55,55,55,55,55,55,55,55,55,55,55,55,55,55,55,55,55,55,55,55,55,181,55,55,135
46,46,46,46,46,140,60,2,55,55,136,55,55,55,55,55,55,55,55,0,61,46,46,46,46,46,46,46,46,46,46,46,46,46,46,46,46,60,2,55,55,55,55,55,55,55,55,55,55,55,55,55,55,55,55,55,55,55,181,55,180,55,55,55,55,180,55,55,55,55,55,55,55,55,136,55,181,55,55,55
46,46,46,46,46,138,46,60,2,55,55,55,180,55,55,55,55,55,55,45,46,46,46,46,46,46,46,46,46,46,46,46,46,46,46,46,46,46,60,1,2,55,55,181,55,55,55,55,55,55,137,55,55,55,55,55,135,182,55,55,55,55,55,55,137,55,55,55,55,55,55,55,55,55,55,55,55,55,55,55
46,46,46,46,46,46,46,46,47,55,55,55,55,55,137,55,55,55,55,45,46,46,138,46,46,46,46,46,46,46,46,46,46,46,183,46,46,46,46,46,60,2,55,55,55,55,55,181,55,55,55,55,137,55,55,55,55,181,55,55,55,181,55,55,55,55,55,55,55,55,55,55,55,55,55,55,55,55,55,55
46,46,46,46,46,140,46,46,60,2,55,55,55,55,55,55,55,55,55,45,46,46,138,46,46,46,46,46,46,46,46,46,46,46,46,184,46,46,46,46,46,60,1,2,55,55,55,55,55,55,55,55,55,55,55,180,55,55,55,55,55,55,55,55,55,55,55,55,55,137,135,55,55,55,55,55,55,55,55,55
46,46,138,46,46,46,46,46,138,47,55,55,180,55,55,55,55,55,55,90,16,46,184,46,46,46,46,46,46,46,46,46,46,46,46,46,46,46,46,46,46,140,184,60,2,55,55,55,55,55,55,135,55,55,55,55,55,55,55,55,55,55,55,55,55,55,55,55,55,55,55,55,55,55,55,55,55,55,55,55
46,46,46,46,46,46,46,46,46,47,55,55,55,55,55,55,55,55,55,55,90,16,46,46,46,46,46,46,46,46,46,46,46,46,46,46,46,138,46,46,46,140,185,46,60,2,55,55,55,55,55,55,55,55,55,55,55,136,55,55,55,55,136,55,55,55,55,55,55,55,55,55,55,55,55,55,55,55,55,55
46,46,46,46,46,46,138,46,46,47,55,55,55,55,55,55,55,55,55,55,55,45,139,46,46,46,46,46,46,46,46,46,46,46,46,46,46,46,46,46,46,46,46,46,46,60,1,1,1,2,55,55,55,55,55,55,55,55,55,137,55,55,55,55,55,55,55,55,55,55,55,55,55,55,55,55,55,55,0,1
46,46,46,46,46,46,46,46,15,92,55,55,55,182,55,55,55,182,55,55,55,45,46,46,46,46,46,46,46,46,46,46,46,46,46,46,46,46,185,46,46,46,46,46,46,46,46,46,46,60,1,1,1,1,2,55,55,55,55,55,55,55,55,55,55,55,55,55,55,55,55,55,0,1,1,2,55,0,61,15
46,46,46,46,46,46,46,46,47,55,180,55,55,55,55,55,55,55,55,55,55,45,46,46,46,139,184,46,46,46,46,46,46,46,46,46,46,46,46,46,46,184,139,184,46,46,46,139,46,46,46,46,185,46,60,1,1,1,1,2,55,0,1,2,55,55,55,0,1,1,1,1,61,46,46,60,1,61,46,47
46,46,46,46,139,46,183,15,92,55,55,55,55,180,55,55,55,55,55,55,55,45,46,46,138,46,46,46,46,46,46,46,46,46,46,46,46,46,46,46,46,46,46,46,46,185,46,46,46,46,46,46,140,46,46,138,46,46,46,60,1,61,46,60,1,1,1,61,46,46,46,46,184,46,46,46,46,46,46,60
46,46,46,46,183,46,140,47,0,1,1,2,55,55,55,55,137,55,55,55,55,90,91,16,184,46,46,46,46,46,46,46,46,46,46,46,46,46,46,46,46,46,46,46,46,46,46,46,46,46,46,46,46,46,46,46,46,46,184,140,46,46,46,46,46,46,46,46,46,46,46,46,46,46,46,46,46,46,46,46
46,46,46,46,46,46,15,92,45,46,46,47,55,55,55,55,55,137,55,55,55,55,55,90,16,46,46,46,46,140,46,46,46,46,46,46,46,46,46,46,46,46,46,46,46,46,46,46,46,46,46,46,46,46,46,46,46,46,46,46,46,46,46,46,46,46,46,46,46,46,46,46,46,46,46,46,46,46,46,46
46,46,46,46,46,184,60,2,90,16,46,60,2,55,55,55,55,55,136,55,55,55,55,55,90,16,184,138,46,139,46,46,46,46,46,46,46,46,46,46,46,46,46,46,46,15,16,46,46,46,46,46,46,46,46,46,46,46,46,46,46,46,46,46,46,46,46,46,46,46,46,46,46,46,46,46,46,46,46,46
46,46,46,46,46,46,46,60,2,45,46,46,47,55,55,55,55,55,55,135,182,55,55,55,55,90,91,16,46,46,183,46,46,46,46,46,46,46,46,46,46,46,46,46,46,60,61,46,46,46,46,46,46,46,15,91,16,46,46,46,46,46,46,46,46,46,46,46,46,46,46,46,46,46,46,46,46,46,46,46
46,46,46,46,46,46,46,46,47,90,91,91,92,55,55,55,181,55,55,55,55,55,55,55,55,55,55,90,16,46,140,183,46,46,46,46,46,46,46,46,46,46,46,46,46,46,46,46,46,46,46,46,46,46,60,1,61,46,46,46,46,46,46,46,46,46,46,46,46,46,46,46,46,46,46,46,46,46,46,46
46,46,46,46,46,46,46,46,60,2,55,55,55,55,55,55,55,55,55,55,55,55,55,55,55,55,55,55,90,16,46,184,46,46,46,46,46,46,46,46,46,46,46,46,46,46,46,46,46,46,46,46,46,46,46,46,46,46,46,46,46,46,46,46,46,46,46,46,46,46,46,46,46,46,46,46,46,46,46,46
46,46,46,46,46,46,46,46,46,60,1,2,55,55,55,55,55,55,55,55,55,55,55,135,55,55,55,55,55,90,91,16,46,46,138,46,46,46,46,46,46,46,46,46,46,46,46,46,46,46,46,46,46,46,46,46,46,46,46,46,46,46,46,46,46,46,46,46,46,46,46,46,46,46,46,46,46,46,46,46
46,46,46,46,46,46,46,46,15,91,16,47,55,55,55,137,55,181,55,180,55,55,55,55,55,55,135,55,55,55,55,90,16,46,46,46,46,184,46,46,46,46,46,46,46,46,46,15,16,46,46,46,46,46,46,46,46,46,46,46,46,46,46,46,46,46,46,46,46,46,46,46,46,46,46,46,46,46,46,46
46,46,46,46,46,46,46,46,60,2,45,60,2,55,55,55,55,55,55,55,55,55,55,55,55,55,55,55,55,55,55,55,90,16,46,46,46,46,184,185,138,46,46,46,46,46,46,60,61,46,46,46,46,46,46,46,46,46,46,46,46,46,46,46,46,46,46,46,46,46,46,46,46,46,46,46,46,46,46,46
46,46,46,46,46,46,46,46,46,60,61,46,60,2,55,55,55,55,55,55,55,55,55,55,55,55,55,55,55,55,55,55,55,45,46,184,46,138,46,138,46,46,184,46,46,46,46,46,46,46,46,46,46,46,46,46,46,46,46,46,46,46,46,46,46,46,46,46,46,46,46,46,46,46,46,46,46,46,46,46
46,46,46,46,46,46,15,16,46,46,46,46,139,47,55,55,55,55,55,55,55,55,181,55,55,182,55,55,55,55,55,55,55,90,91,91,91,91,16,46,46,46,183,46,46,46,46,46,46,46,46,46,46,46,46,46,46,46,46,46,46,46,46,46,46,46,46,46,46,46,46,46,46,46,46,46,46,46,46,46
46,46,46,46,139,46,47,45,46,46,138,140,185,60,1,2,55,137,55,55,55,55,136,55,55,55,182,136,55,55,180,55,55,55,55,55,55,55,90,91,16,46,184,138,46,46,46,46,46,46,46,46,46,46,46,46,46,46,46,46,46,46,46,46,46,46,46,46,46,46,46,46,46,46,46,46,46,46,46,46
46,46,46,46,183,46,60,61,46,46,46,183,46,46,46,60,2,55,55,55,55,55,55,55,55,55,55,55,55,55,55,55,55,55,55,55,55,55,55,55,90,16,139,138,46,46,46,46,184,46,46,46,46,46,46,46,46,46,46,46,46,46,46,46,46,46,46,46,46,46,46,46,46,46,46,46,46,46,46,46
46,46,139,46,46,46,46,46,138,138,46,46,46,46,46,46,60,2,55,55,55,55,135,135,55,55,55,55,135,55,180,180,55,55,182,55,55,55,55,55,55,90,16,46,140,185,138,46,46,46,46,46,46,46,46,46,46,46,46,46,46,46,46,46,46,46,46,46,46,46,46,46,46,46,46,46,46,46,46,46
46,46,46,46,46,46,46,46,46,46,46,185,46,46,46,46,46,60,2,55,55,55,55,55,55,55,55,55,55,55,55,182,55,55,55,55,55,55,180,55,55,55,45,46,185,185,46,46,46,46,46,46,46,46,46,46,46,46,46,46,46,46,46,46,46,46,46,46,46,46,46,46,46,46,46,46,46,46,46,46
46,46,46,46,46,46,46,46,46,46,46,46,46,46,46,15,91,16,60,2,55,55,55,55,55,55,55,55,55,55,55,55,55,55,55,135,55,55,181,55,55,55,45,46,15,16,140,46,46,46,46,46,46,46,46,46,46,46,46,46,46,46,46,46,46,46,46,46,46,46,46,46,46,46,46,46,46,46,46,46
46,46,46,46,46,46,46,46,138,46,46,46,184,46,46,60,2,45,46,60,1,2,55,55,55,55,55,55,55,55,55,55,55,55,55,136,55,55,55,181,55,55,45,46,60,61,46,46,46,46,46,46,46,46,46,46,46,46,46,46,46,46,46,46,46,46,46,46,46,46,46,46,46,46,46,46,46,46,46,183
46,46,46,46,46,46,46,46,46,46,46,46,46,46,46,46,60,61,46,46,46,47,55,55,55,55,55,55,55,55,55,135,55,55,55,55,55,55,136,55,55,55,45,140,46,46,46,46,46,46,46,46,46,46,46,46,46,46,46,46,46,46,46,46,46,46,46,46,46,46,46,46,46,46,46,46,46,46,46,46
46,46,46,46,46,46,46,46,46,46,46,46,46,46,183,46,46,15,91,16,46,47,55,55,55,55,55,55,55,55,55,55,55,55,55,55,55,55,55,55,55,55,45,46,46,139,140,46,46,46,46,46,46,46,46,46,46,46,46,46,46,46,46,46,46,46,46,46,46,46,46,46,15,91,16,46,46,46,15,91
46,46,46,46,46,46,46,46,46,46,46,46,46,46,46,46,46,60,2,45,46,60,1,1,2,55,55,55,55,55,55,55,55,55,55,55,181,55,55,55,55,55,45,46,46,138,183,15,16,46,46,46,46,46,46,46,46,46,46,46,46,46,46,46,46,46,46,46,140,184,15,16,60,1,61,46,15,91,92,55
46,46,46,46,46,46,46,46,46,46,46,46,46,46,46,46,46,46,47,45,46,185,46,46,60,1,1,2,55,55,55,55,55,55,55,55,55,55,55,55,55,55,45,46,46,46,140,60,61,46,46,46,46,46,46,46,46,46,46,46,46,46,46,46,46,46,46,46,46,46,60,61,183,46,15,91,92,55,55,55
46,46,46,46,46,46,46,46,46,46,46,46,46,46,46,46,46,46,60,61,46,46,46,46,46,46,46,60,1,1,2,55,55,55,55,55,55,55,55,55,55,0,61,138,46,46,46,46,46,46,46,46,46,46,46,15,16,46,46,46,46,46,46,46,46,46,46,46,46,46,46,46,15,91,92,55,55,55,55,55
46,46,46,46,46,46,46,46,46,46,46,46,46,46,46,46,46,46,46,46,46,46,46,138,46,46,46,46,183,46,60,1,1,2,55,55,55,55,55,55,55,45,46,183,139,46,46,46,46,46,46,46,46,46,46,60,61,46,46,46,46,46,46,46,46,46,15,91,91,91,91,91,92,55,55,55,55,181,55,55
46,46,46,46,46,46,46,46,46,46,46,46,46,46,46,46,46,46,46,46,46,185,184,185,46,183,46,46,140,46,46,46,46,60,1,1,1,1,1,1,1,61,46,140,183,46,139,46,46,46,46,46,46,46,46,46,46,46,46,46,46,46,46,46,46,15,92,55,55,55,55,55,55,55,55,55,55,55,55,55
46,46,46,46,46,46,46,46,46,46,46,46,46,46,46,46,46,46,46,46,46,46,46,185,140,46,46,46,46,46,140,46,46,46,46,185,46,46,46,140,139,46,46,184,46,46,46,139,46,46,46,46,46,46,46,46,46,46,46,46,184,46,46,46,15,92,55,55,55,55,55,136,55,55,55,137,135,55,55,55
46,46,46,46,46,46,46,46,46,46,46,46,46,46,46,46,46,46,46,46,46,46,46,46,140,46,46,46,46,140,139,139,46,183,46,46,46,46,46,46,183,184,138,46,46,46,46,46,46,46,46,46,46,46,46,46,46,46,46,46,46,46,46,15,92,55,55,55,55,55,55,55,55,55,55,55,55,55,55,180
46,46,46,46,46,46,46,46,46,46,46,46,46,46,46,46,46,46,46,46,46,46,46,46,46,46,46,46,46,46,46,46,46,46,46,46,183,46,46,46,185,46,46,46,46,46,46,46,46,46,46,46,46,46,46,46,46,46,46,46,46,46,15,92,55,55,137,55,55,55,55,55,137,55,55,55,55,55,55,55
46,46,46,46,46,46,46,46,46,46,46,46,46,46,46,46,46,46,46,46,46,46,46,46,46,46,46,46,46,46,46,46,46,46,46,46,46,185,184,185,139,46,46,46,46,46,46,46,46,46,46,46,46,46,46,46,46,46,46,46,46,15,92,55,55,55,55,55,55,55,55,55,55,55,55,55,55,135,55,55
46,46,46,46,46,46,46,46,46,46,46,46,46,46,46,46,46,46,46,46,46,46,46,46,46,46,46,46,46,46,46,46,46,46,46,46,46,46,46,46,46,46,46,46,46,46,46,46,46,46,46,46,46,46,46,46,46,46,46,46,15,92,55,55,55,55,55,55,55,55,55,55,182,55,55,55,55,55,55,135
46,46,46,46,46,46,46,46,46,46,46,46,46,46,46,46,46,46,46,46,46,46,46,46,46,46,46,46,46,46,46,46,46,46,46,46,46,46,46,46,46,46,46,46,46,46,46,46,46,46,46,46,46,46,46,46,46,46,46,15,92,55,182,55,55,55,136,55,55,55,55,55,55,55,55,55,55,55,55,55
46,46,46,46,46,46,46,46,46,46,46,46,46,46,46,46,46,46,46,46,46,46,46,46,46,46,46,46,46,46,46,46,46,46,46,46,46,46,46,46,46,46,46,46,46,46,46,46,46,46,46,46,46,46,46,46,46,46,15,92,55,55,55,55,55,55,55,55,55,135,136,182,55,55,55,55,55,55,55,55
46,46,46,46,46,46,46,46,46,46,46,46,46,46,46,46,46,46,46,46,46,46,46,46,46,46,46,46,46,46,46,46,46,46,46,46,46,46,46,46,46,46,46,46,46,46,46,46,46,138,138,183,184,46,138,46,46,46,47,55,55,55,55,55,55,55,55,55,55,55,55,55,55,55,55,55,0,1,1,1
46,46,46,46,46,46,46,46,46,46,46,46,46,46,46,46,46,46,46,46,46,46,46,46,46,46,46,46,46,46,46,46,46,46,46,46,46,46,46,46,46,46,46,46,46,46,46,46,46,46,46,46,46,185,46,46,46,15,92,55,55,55,136,55,55,55,55,180,55,55,55,55,55,0,1,1,61,46,46,140
46,46,46,46,46,46,46,46,46,46,46,46,46,46,46,46,46,46,46,46,46,46,46,46,46,46,46,46,46,46,46,46,46,46,46,46,46,46,46,46,46,46,46,46,46,46,46,46,46,46,46,139,140,46,15,91,16,47,55,55,55,55,55,55,55,182,55,55,55,55,55,55,55,45,46,46,46,46,140,46
46,46,46,46,46,46,46,46,46,46,46,46,46,46,46,46,46,46,46,46,46,46,46,46,46,46,46,46,46,46,46,46,46,46,46,46,46,46,46,46,46,46,46,46,46,46,46,46,46,46,46,46,46,46,47,0,61,47,55,55,55,55,55,55,55,55,55,55,55,55,55,55,0,61,46,46,46,46,46,46
46,46,46,46,46,46,46,46,46,46,46,46,46,46,46,46,46,46,46,46,46,46,46,46,46,46,46,46,46,46,46,46,46,46,46,46,46,46,46,46,46,46,46,46,46,46,46,46,46,183,46,46,46,15,92,45,46,47,55,55,55,55,55,55,55,55,180,55,55,55,55,0,61,46,46,185,46,46,46,46
46,46,46,46,46,46,46,46,46,46,46,46,46,46,46,46,46,46,46,46,46,46,46,46,46,46,46,46,46,46,46,46,46,46,46,46,46,46,46,46,46,46,46,46,46,46,46,46,46,46,184,46,46,47,0,61,15,92,55,181,55,55,55,182,55,55,55,55,55,0,1,61,46,15,16,46,46,46,46,46
46,46,46,46,46,46,46,46,46,46,46,46,46,46,46,46,46,46,46,46,46,46,46,46,46,46,46,46,46,46,46,46,46,46,46,46,46,46,46,46,46,46,46,46,46,46,46,46,46,46,15,91,16,60,61,46,47,55,55,55,135,55,55,55,55,55,0,1,1,61,46,46,46,60,61,46,46,46,46,46
46,46,46,46,46,46,46,46,46,46,46,46,46,46,46,46,46,46,46,46,46,46,46,46,46,46,46,46,46,46,46,46,46,46,46,46,46,46,46,46,46,46,46,46,46,46,46,46,46,46,47,0,61,46,46,15,92,55,55,55,55,55,55,55,55,0,61,46,46,46,15,16,46,46,46,184,46,46,46,46
