280,280,280,280,280,280,280,280,280,280,280,280,280,280,280,280,280,280,280,280,280,280,280,280,280,280,280,280,280,280,280,280,280,270,271,271,271,271,271,271,271,271,272,280,280,280,280,362,362,280,280,280,280,280,280,280,280,280,280,280,280,280,280,280,280,280,280,280,225,286,271,271,271,271,271,271,271,271,271,271
280,280,280,280,280,280,280,280,280,280,280,280,280,280,280,280,280,280,280,280,280,280,280,280,280,280,280,280,280,280,280,225,226,286,271,240,241,271,271,271,271,271,272,280,280,280,280,280,280,280,280,280,280,280,280,280,280,280,280,280,280,280,280,280,280,280,225,226,286,271,271,271,271,271,271,271,271,271,271,271
280,280,280,280,280,280,280,280,280,280,280,280,280,280,280,280,280,280,280,280,280,280,280,280,280,280,280,280,280,280,280,270,271,271,271,272,270,271,271,240,241,271,285,227,280,280,280,280,280,280,280,280,405,407,280,280,280,280,280,280,280,280,280,280,280,225,286,271,271,271,271,271,271,271,271,271,271,271,271,271
280,280,280,280,280,280,280,280,280,280,280,280,280,280,280,280,280,280,280,280,280,280,280,280,280,280,280,280,280,280,280,270,271,271,240,317,270,271,271,285,286,271,271,285,227,280,280,280,280,280,280,280,280,280,280,280,405,280,280,280,280,280,280,280,225,286,271,271,271,271,271,271,271,271,271,271,271,271,271,271
280,280,280,280,280,280,280,280,280,280,280,280,280,280,280,280,280,280,280,280,280,280,280,280,280,280,280,280,280,225,226,286,271,271,285,226,286,271,271,271,271,271,271,271,272,280,280,280,280,280,280,280,280,280,280,280,362,280,280,280,280,280,280,280,270,271,271,271,271,271,271,271,271,271,271,271,271,271,271,271
280,280,280,280,280,280,280,280,280,280,280,280,280,280,280,280,280,280,280,280,280,280,280,280,280,280,280,280,225,286,271,271,271,271,271,271,271,271,271,271,271,271,271,271,272,280,280,280,280,280,280,280,280,280,280,280,361,280,280,280,280,280,280,280,270,271,271,271,271,271,271,271,271,271,271,271,271,271,271,271
280,280,280,280,280,280,280,280,280,280,280,280,280,280,280,280,280,280,280,280,280,280,280,280,280,225,226,226,286,271,271,271,271,271,271,271,271,271,271,271,271,271,271,271,285,227,280,280,280,280,280,280,280,280,280,280,405,280,280,280,280,280,280,280,315,316,241,271,271,271,271,271,271,271,271,271,271,271,271,271
280,280,280,280,280,280,280,280,280,280,280,280,280,280,280,280,280,280,280,280,280,280,280,225,226,286,271,271,271,271,271,271,271,271,271,271,271,271,271,271,271,271,409,271,271,285,227,280,280,280,280,280,280,280,280,280,405,280,280,280,280,280,280,280,280,280,315,316,241,271,271,271,271,271,271,271,271,271,271,271
280,280,280,280,280,280,280,280,280,280,280,280,280,280,280,280,280,280,280,280,280,280,225,286,271,271,271,271,271,271,271,271,271,271,271,271,271,271,271,271,271,271,409,271,271,271,272,280,280,280,280,280,280,280,280,280,280,362,280,280,280,280,280,280,280,280,280,280,315,316,316,316,316,316,241,271,271,271,271,271
280,280,280,280,280,280,280,280,280,280,280,280,280,280,280,280,280,280,280,280,280,225,286,271,271,240,316,241,271,271,271,271,271,240,316,316,241,271,271,271,271,271,410,240,241,271,285,227,280,280,280,280,280,280,280,280,280,407,280,280,280,280,280,280,280,280,280,280,280,280,280,280,280,280,270,271,271,271,271,271
280,280,280,280,280,280,280,280,280,280,280,280,280,280,280,280,280,280,280,280,225,286,271,271,271,285,226,286,271,271,271,271,271,285,226,226,286,271,271,271,271,271,410,272,315,241,271,285,226,227,280,280,280,280,280,280,280,361,280,280,280,280,280,280,280,280,280,280,280,280,280,280,280,280,315,316,316,241,271,271
280,280,280,280,280,280,280,280,280,280,280,280,280,280,280,280,280,280,280,280,270,271,240,316,241,271,271,271,271,271,271,271,271,271,271,271,271,271,240,241,271,271,363,285,226,286,271,271,271,285,227,280,280,280,280,280,280,280,362,280,280,280,280,280,280,280,280,280,280,280,280,280,280,280,280,280,280,315,316,241
280,280,280,280,280,280,280,280,280,280,280,280,280,280,280,280,280,280,280,225,286,271,285,226,286,271,271,271,271,271,271,271,271,271,271,271,271,271,285,286,271,271,408,271,271,271,271,271,271,271,285,227,280,280,280,280,280,280,407,280,280,280,280,280,280,280,280,280,280,280,280,280,280,280,280,280,280,280,280,315
280,280,280,280,280,280,280,280,280,280,280,280,280,280,280,280,280,280,280,270,271,240,241,271,271,271,271,271,271,271,271,271,271,271,271,271,271,271,271,271,271,271,410,271,271,271,271,271,240,316,241,285,227,280,280,280,280,280,280,280,280,280,280,280,280,280,280,280,280,280,280,280,280,280,280,280,280,280,280,280
280,280,280,280,280,280,280,280,280,280,280,280,280,280,280,280,280,280,225,286,271,285,286,271,240,316,241,271,271,240,241,271,240,316,316,241,271,271,271,271,271,271,409,271,271,271,271,271,285,226,286,271,272,280,280,280,280,280,280,280,280,280,280,280,280,280,280,280,280,280,280,280,280,280,280,280,280,280,280,280
280,280,280,280,280,280,280,280,280,280,280,280,280,280,280,280,280,280,270,271,271,271,271,271,285,226,286,271,240,317,315,316,317,280,280,270,271,271,271,271,271,271,410,271,271,271,271,271,271,271,271,271,285,226,226,226,227,280,280,280,280,280,280,280,280,280,280,280,280,280,280,280,280,280,280,280,280,280,280,280
280,280,280,280,280,280,280,280,280,280,280,280,280,280,280,280,225,226,286,271,271,271,271,271,271,271,240,316,317,280,280,280,280,280,280,315,241,271,240,241,271,271,364,271,271,271,271,271,271,271,271,271,271,271,271,271,272,280,280,280,280,280,280,280,280,280,280,280,280,280,280,280,280,280,280,407,280,280,280,280
280,280,280,280,280,280,280,280,280,280,280,280,280,280,280,225,286,271,271,271,271,271,271,271,240,316,317,280,280,280,280,280,280,280,280,361,270,271,272,270,271,271,364,271,271,271,271,271,271,271,271,271,271,271,271,271,285,227,280,280,280,280,280,280,280,280,280,280,280,280,280,280,280,280,280,280,280,280,280,280
280,280,280,280,280,280,280,280,280,280,280,280,280,280,225,286,271,271,271,271,271,271,271,240,317,280,280,280,280,280,280,280,280,280,280,407,270,271,285,286,271,240,316,241,271,271,271,271,271,271,271,271,271,271,271,271,271,285,227,280,280,280,280,280,280,280,280,280,280,280,280,280,280,280,280,280,280,280,280,280
280,280,280,280,280,280,280,280,280,280,280,280,280,225,286,271,271,271,271,271,271,240,316,317,280,280,405,280,280,405,407,407,280,280,360,280,315,241,271,271,271,285,226,286,271,271,271,271,271,271,271,271,271,271,271,271,271,271,285,227,280,280,280,280,280,280,280,280,280,280,280,280,280,280,280,280,280,280,280,280
280,280,280,280,280,280,280,280,280,280,280,225,226,286,271,271,271,271,271,271,240,317,280,280,361,280,406,280,280,280,280,280,280,280,405,225,226,286,271,271,271,271,410,271,271,271,271,271,271,271,271,271,271,271,271,271,271,271,271,272,280,280,280,280,280,407,280,280,280,280,280,280,280,280,280,280,280,280,280,280
280,280,280,280,280,280,280,280,280,280,225,286,271,271,271,271,271,271,240,316,317,280,280,280,405,280,406,280,280,280,280,280,280,360,225,286,271,271,271,271,271,271,410,271,271,271,271,271,271,271,271,271,271,271,271,271,271,271,271,285,227,280,280,280,280,280,280,280,280,280,280,280,280,280,280,280,280,280,280,280
280,280,280,280,280,280,280,280,225,226,286,271,271,271,271,271,240,316,317,280,280,280,280,280,280,360,280,280,280,362,280,280,280,406,270,271,271,271,271,271,271,271,363,271,271,271,271,271,271,271,271,271,271,271,271,271,271,271,271,271,285,227,280,280,280,280,280,280,280,280,280,280,280,280,280,280,280,280,280,280
280,280,280,280,280,280,280,225,286,271,271,271,271,271,240,316,317,280,406,280,280,280,280,280,280,406,280,280,280,280,360,280,405,280,270,271,271,271,271,271,271,271,363,271,271,271,240,241,271,240,241,271,271,271,271,271,271,271,271,271,271,272,280,280,280,280,280,280,280,280,280,280,280,280,280,280,280,280,280,280
280,280,280,280,280,280,225,286,271,271,271,271,271,240,317,361,280,280,406,360,280,280,280,280,407,280,280,280,280,280,280,280,406,280,270,271,271,271,271,271,271,271,409,271,271,271,285,286,271,285,286,271,271,240,241,271,271,271,240,316,241,285,227,280,280,360,280,280,280,280,361,280,280,280,280,280,280,280,280,280
280,280,280,280,280,225,286,271,271,271,271,271,240,317,280,280,280,280,280,280,280,280,280,280,280,280,280,280,280,280,280,360,280,280,270,271,271,271,271,240,241,271,410,271,271,271,271,271,271,271,271,271,271,285,286,271,271,271,285,227,270,271,272,280,280,280,280,280,280,280,406,280,280,280,280,280,280,280,361,280
280,280,280,280,280,270,271,271,271,271,271,240,317,280,280,280,280,280,280,280,280,280,280,280,280,280,280,280,280,280,280,280,280,280,270,271,271,240,241,285,286,271,365,271,271,271,271,271,271,271,271,271,271,271,271,271,271,271,271,272,270,271,272,280,280,280,280,280,280,280,280,405,360,280,280,280,280,280,361,280
280,280,280,280,280,270,271,271,271,271,240,317,280,280,280,280,280,280,280,361,280,280,280,280,407,280,280,280,280,280,280,280,280,280,270,271,271,285,286,271,271,271,364,271,271,271,271,271,271,271,271,271,271,271,271,271,271,271,271,285,286,271,272,280,280,280,280,280,280,280,280,280,407,280,280,280,280,280,361,280
280,280,280,280,280,270,271,271,271,271,272,280,280,280,280,280,280,280,280,280,280,280,280,407,362,405,280,280,280,280,280,280,280,280,270,271,271,271,271,271,271,271,363,271,271,271,271,271,271,271,271,271,271,271,271,271,271,271,271,271,271,271,272,280,280,280,280,280,280,280,280,280,280,280,280,280,280,280,280,280
280,280,280,280,280,270,271,271,271,240,317,280,280,280,280,280,280,280,280,280,280,280,280,280,280,360,280,280,280,280,280,280,280,280,270,271,271,271,271,271,271,271,408,271,271,271,271,271,271,271,271,271,271,271,271,271,271,271,271,271,271,271,272,280,280,280,280,280,280,280,280,280,280,280,280,280,280,280,280,280
280,280,280,280,280,315,316,316,316,317,280,280,280,280,280,280,280,280,280,280,280,280,280,280,280,360,405,361,280,280,280,280,280,280,270,271,271,271,271,271,271,271,410,271,271,271,271,271,271,271,271,271,271,271,271,271,271,271,271,240,241,408,272,280,280,280,280,280,280,280,280,280,280,280,280,280,280,280,280,280
280,280,280,280,280,280,280,280,280,405,280,280,280,280,362,407,280,280,280,280,280,280,280,280,280,280,280,405,280,280,280,280,280,280,270,271,240,316,241,271,271,271,408,271,271,271,271,271,271,271,271,240,316,241,271,271,271,240,241,285,286,410,272,280,280,280,280,280,280,280,280,280,280,280,280,280,280,280,280,280
280,280,280,280,280,280,280,280,280,407,280,280,362,361,280,280,280,280,280,362,361,280,280,280,280,280,405,362,280,280,280,280,280,280,270,271,285,227,270,271,271,271,365,271,271,271,271,271,271,240,241,285,226,286,364,365,363,285,286,271,271,240,317,280,280,280,280,280,280,280,280,280,280,280,280,280,280,362,405,280
280,280,280,280,280,280,280,280,280,361,280,280,280,280,280,362,405,280,280,360,280,280,406,360,280,280,280,406,280,280,280,280,280,280,315,241,271,272,315,241,271,271,271,271,271,271,271,271,271,285,286,271,271,271,271,271,271,271,271,240,316,317,280,280,360,280,280,280,280,280,280,280,280,280,280,280,280,280,280,280
280,280,280,280,280,280,280,280,280,280,280,280,280,280,405,406,280,280,280,360,280,280,360,280,280,280,280,280,280,280,280,280,280,280,280,270,271,285,226,286,271,271,364,271,271,271,271,271,271,363,271,271,240,316,316,316,316,316,316,317,280,280,280,406,361,280,280,280,280,362,280,280,280,280,280,280,280,362,280,280
280,280,280,280,280,280,280,280,280,280,280,280,280,407,406,280,280,280,280,362,280,280,280,280,280,280,280,280,280,280,280,280,280,280,280,315,316,241,271,271,271,271,410,364,271,271,240,316,316,316,316,316,317,280,360,362,280,280,280,280,280,280,280,407,405,280,280,280,280,405,280,280,280,280,280,280,280,280,280,280
280,280,280,280,280,280,280,280,280,280,280,280,280,280,280,280,280,280,280,406,280,280,280,280,280,280,280,280,280,280,280,280,280,280,280,280,280,315,316,316,316,316,316,316,316,316,317,280,280,280,280,280,280,280,280,280,280,280,280,280,280,280,280,280,280,280,280,360,407,406,280,280,280,280,280,280,280,280,280,280
407,361,280,280,280,280,280,280,280,280,280,280,280,280,280,280,280,280,280,280,280,280,280,280,280,280,280,280,280,280,280,280,280,280,280,280,280,280,280,280,280,280,280,280,280,280,280,280,280,280,280,280,280,280,280,280,280,280,280,280,280,280,280,280,280,407,362,360,280,280,280,280,280,280,280,280,280,280,280,280
280,360,280,280,280,280,280,280,280,280,280,280,280,280,280,280,280,280,280,280,280,280,280,280,280,280,280,280,280,280,280,280,280,280,280,280,280,280,280,280,280,280,280,280,280,280,280,280,280,280,280,280,280,280,280,280,280,280,280,280,280,280,280,280,280,280,280,280,280,280,280,280,280,280,280,280,280,280,280,280
280,280,280,280,405,280,280,280,280,280,280,280,280,280,280,280,280,407,280,280,280,280,280,280,280,280,280,280,280,280,280,280,280,280,280,280,280,280,280,280,280,280,280,280,280,280,280,280,280,280,280,280,280,280,280,280,280,280,280,280,280,280,280,280,280,280,280,280,280,280,280,280,280,280,280,280,280,280,280,280
280,280,280,280,280,280,361,280,280,280,280,280,280,280,280,280,280,280,280,280,280,280,280,280,280,280,280,280,280,280,280,280,280,280,280,280,280,280,280,280,405,361,280,280,280,280,280,280,280,362,406,362,280,280,280,280,280,280,280,280,280,280,280,280,280,280,280,280,280,280,280,280,280,280,280,280,280,280,225,226
280,280,280,280,280,406,280,280,280,280,280,280,280,280,280,280,280,280,280,280,280,280,280,280,280,280,280,280,280,280,280,407,406,361,280,280,280,280,280,280,280,280,280,280,280,280,280,280,280,280,280,280,280,280,280,280,280,280,280,280,280,361,280,280,280,280,280,280,280,361,280,280,280,280,280,280,225,226,286,271
280,280,280,280,407,280,280,280,280,280,280,280,280,280,280,280,407,280,280,280,280,280,280,280,361,407,280,280,280,280,280,280,280,280,280,280,280,280,280,280,280,280,280,280,280,280,280,280,280,280,280,280,280,280,280,280,280,280,280,280,280,280,280,280,280,280,280,405,362,406,280,280,280,280,225,226,286,271,271,271
280,280,280,280,406,280,280,280,280,280,280,280,280,280,280,280,280,280,280,280,407,361,280,280,280,280,280,280,280,280,280,280,280,280,280,280,280,280,280,280,280,280,280,280,280,280,360,280,280,280,280,280,280,280,280,361,280,280,280,280,280,280,362,407,406,407,405,280,280,280,280,225,226,226,286,271,271,271,271,271
280,361,280,280,280,280,280,280,280,280,280,280,280,280,280,280,280,280,280,280,280,360,406,280,280,280,280,280,280,280,280,280,280,280,280,280,280,280,280,280,280,280,280,280,280,280,280,280,280,280,280,280,280,280,361,280,280,280,280,280,280,280,280,280,280,280,280,280,225,226,226,286,271,271,271,271,271,271,271,271
280,360,280,280,280,280,280,280,280,406,280,280,405,362,280,280,280,280,280,280,280,280,280,280,280,280,280,280,280,280,280,280,280,280,280,280,225,226,226,226,226,226,226,226,226,226,226,227,280,280,280,280,280,280,280,280,280,280,280,280,280,280,280,225,226,226,226,226,286,271,271,271,271,271,271,271,271,271,271,271
280,280,280,280,280,280,280,280,280,362,360,362,280,280,280,280,280,280,280,280,280,280,280,280,280,280,280,280,280,225,226,226,226,226,226,226,286,271,271,271,271,271,271,271,271,271,271,272,280,280,280,280,280,280,280,280,280,225,226,226,226,226,226,286,271,271,271,271,271,271,271,271,271,240,316,316,241,271,271,271
280,280,280,280,280,280,280,280,406,362,280,280,280,280,280,280,280,225,226,226,226,226,226,226,226,226,226,226,226,286,271,271,271,271,271,271,271,271,271,271,271,271,271,271,271,271,271,285,226,226,226,226,226,227,225,226,226,286,271,271,271,271,271,271,271,271,271,240,241,271,271,271,271,285,226,226,286,271,271,271
280,280,280,407,280,280,280,280,280,280,280,280,280,225,226,226,226,286,271,271,271,271,271,271,271,271,271,271,271,271,271,271,271,271,271,271,271,271,271,271,271,271,271,271,271,271,271,271,271,271,271,271,271,285,286,271,271,271,271,271,271,271,271,240,316,316,316,317,315,316,316,241,271,271,271,271,271,271,271,271
362,405,280,407,280,280,280,280,280,280,280,280,225,286,271,271,271,271,271,271,271,271,271,271,271,271,271,271,271,271,271,271,271,271,271,271,271,271,271,271,271,271,271,271,271,271,271,271,271,271,271,271,271,271,271,271,271,240,316,316,316,316,280,280,280,280,280,280,280,280,280,280,316,316,316,316,316,316,316,241
280,280,280,280,360,407,360,280,280,280,280,225,286,271,240,241,271,271,271,271,271,271,271,271,271,271,271,271,271,271,271,271,271,271,271,271,271,271,271,271,271,271,271,271,271,271,271,271,271,240,316,316,360,361,407,405,405,280,280,280,280,362,362,360,280,280,280,280,280,280,280,280,280,280,280,280,280,280,280,315
280,280,280,280,280,280,280,280,280,280,225,286,271,271,285,286,271,271,271,271,271,271,271,271,271,271,271,271,271,271,271,271,271,271,271,271,271,271,271,271,271,271,271,271,240,280,280,280,280,280,280,280,280,280,280,280,280,280,280,280,280,280,280,280,280,280,280,280,280,280,280,280,280,280,280,280,280,280,280,280
280,280,280,280,280,280,280,280,225,226,286,271,271,271,271,271,271,271,271,271,271,271,271,271,271,271,271,271,271,271,271,271,271,271,271,271,271,271,271,271,271,271,240,280,280,280,280,280,280,280,280,280,280,280,280,280,280,280,225,226,226,226,226,226,226,226,226,226,227,280,280,280,280,280,280,225,226,226,227,280
280,280,280,280,280,280,280,225,286,271,271,271,271,271,271,271,271,271,271,271,271,271,271,271,271,271,271,271,271,271,271,271,271,271,271,271,271,271,271,271,240,280,280,280,280,280,280,280,280,280,280,280,280,280,280,280,280,280,270,271,271,271,271,271,271,271,271,271,285,226,226,226,226,226,227,270,271,271,285,227
280,280,280,280,280,225,226,286,271,240,316,241,271,271,271,271,271,271,271,271,271,271,271,271,271,271,271,271,271,271,271,271,271,271,271,271,240,316,316,280,280,280,280,280,280,280,280,280,405,280,280,280,280,280,280,280,280,280,315,316,316,316,241,271,271,271,271,271,271,271,271,271,271,271,285,286,271,271,271,285
280,280,280,225,226,286,271,271,271,285,226,286,271,271,271,271,271,271,271,271,271,271,271,271,271,271,271,280,280,280,280,280,280,280,280,280,280,280,280,280,280,280,280,280,280,280,280,280,280,280,280,280,280,280,280,405,280,280,280,280,280,280,315,316,316,316,316,316,241,271,271,271,271,271,271,271,271,271,271,271
226,226,226,286,271,271,271,271,271,271,271,271,271,271,271,271,271,271,271,271,240,280,280,280,280,280,280,280,280,280,280,280,280,280,280,280,280,280,280,280,280,280,280,280,280,280,280,280,280,280,280,280,280,280,280,280,280,280,280,280,280,280,280,280,280,280,280,280,315,316,241,271,271,271,271,271,240,316,241,271
271,271,271,271,271,271,271,271,271,271,271,271,271,271,271,271,271,280,280,280,280,280,280,280,280,225,226,226,226,226,227,280,280,280,280,225,226,226,226,226,226,226,227,280,280,280,280,280,280,280,280,280,280,280,280,280,280,280,280,280,280,280,280,280,280,406,280,280,280,280,315,316,241,271,271,271,285,227,315,241
271,271,271,271,271,271,271,271,271,271,271,271,271,271,271,280,280,280,280,280,280,280,225,226,226,286,271,271,271,271,285,226,226,226,226,286,271,271,271,271,271,271,272,280,280,280,280,280,280,280,280,280,280,280,280,280,280,280,280,280,280,280,280,280,280,280,280,406,280,280,280,280,315,316,241,271,271,285,227,270
271,271,271,271,271,271,271,271,271,271,271,271,271,280,280,280,280,280,280,280,225,226,286,271,271,271,271,271,271,271,271,271,271,271,271,271,240,316,316,316,316,316,317,280,280,280,280,280,280,280,280,280,280,280,280,280,280,280,280,280,280,280,280,280,280,280,280,405,280,280,280,280,280,280,315,316,241,271,285,286
271,271,271,271,271,271,271,271,271,271,271,271,280,280,280,225,226,226,226,226,286,271,271,271,271,271,271,271,271,271,271,271,240,316,316,316,317,280,360,280,280,280,280,280,280,280,280,280,280,280,280,280,280,280,280,280,280,280,280,280,280,280,280,362,280,280,407,280,280,280,280,280,280,280,280,280,315,241,271,271
271,271,271,271,271,271,271,271,271,271,240,280,280,280,280,270,271,271,271,271,271,271,271,271,271,240,316,316,316,316,316,316,317,280,280,280,280,280,407,280,280,280,280,280,280,280,405,405,360,280,280,280,280,280,280,280,280,280,280,280,280,280,280,405,280,280,406,280,280,280,280,280,280,280,280,280,280,315,241,271
271,271,271,271,271,271,271,271,271,271,285,280,280,225,226,286,271,271,240,241,271,271,271,240,316,317,280,280,280,280,280,280,407,406,280,280,280,280,280,280,280,280,280,280,280,280,280,280,280,280,280,361,280,280,280,280,280,280,360,280,280,280,405,280,280,407,280,280,280,280,280,280,280,280,280,280,280,280,315,241
271,271,271,271,271,271,271,271,271,271,271,280,280,270,271,271,271,271,285,286,271,271,240,317,280,280,280,280,280,280,280,406,280,280,362,280,280,280,280,280,280,280,280,280,280,280,280,280,280,280,280,280,280,360,280,280,280,280,280,280,280,360,280,280,407,280,280,280,280,280,280,280,280,280,280,280,280,280,280,270
271,271,271,271,271,271,271,271,271,271,271,280,280,315,316,316,241,271,271,271,271,271,272,280,280,280,280,280,280,280,280,280,280,280,280,280,280,280,280,280,280,280,405,361,280,280,280,280,280,280,280,280,280,280,280,280,280,280,280,405,407,280,280,280,280,280,280,280,280,280,280,280,280,280,280,280,280,280,225,286
271,271,271,271,271,271,271,271,271,271,271,280,280,280,280,280,315,241,271,271,271,271,285,226,226,227,280,280,280,280,280,280,280,280,280,280,280,280,280,280,280,280,280,280,280,280,280,280,280,280,280,405,280,280,280,280,280,280,280,280,280,280,280,280,280,280,280,280,280,280,280,280,407,280,280,280,280,280,270,271
271,271,271,271,271,271,271,271,271,271,271,272,280,280,280,280,280,315,316,241,271,271,271,271,271,285,226,226,227,280,280,280,280,280,280,280,280,280,280,280,280,280,280,280,280,280,280,280,280,280,406,406,280,280,280,280,280,280,280,280,280,280,280,280,280,280,280,280,280,407,280,280,280,280,280,280,280,280,270,271
271,271,271,271,271,271,271,271,271,271,271,272,280,280,280,280,280,280,280,270,271,271,271,271,271,271,271,271,285,226,227,280,280,280,225,226,227,280,280,280,280,280,361,407,280,280,280,280,280,280,280,406,362,361,280,280,280,280,280,280,280,280,280,280,280,280,280,280,280,362,280,280,280,280,280,280,280,225,286,271
271,271,271,271,271,271,271,271,271,271,240,317,280,280,280,280,280,280,280,270,271,271,271,271,271,271,271,271,271,271,285,226,226,226,286,271,272,280,280,280,280,280,280,407,361,280,280,280,280,280,280,280,280,280,280,406,280,280,280,280,280,280,280,280,280,280,280,280,280,280,280,280,280,280,280,280,225,286,271,271
271,271,271,271,271,271,271,271,271,271,272,280,280,280,280,280,280,280,280,315,316,241,271,271,271,271,271,271,271,271,271,271,271,271,271,271,272,280,280,280,280,280,280,280,280,280,280,280,280,280,280,280,280,280,407,362,280,280,280,280,280,280,280,280,280,280,280,280,280,280,280,280,280,280,280,280,270,271,271,271
271,271,271,271,271,271,271,271,271,271,272,280,280,280,280,280,280,280,280,406,406,270,271,271,271,271,271,271,271,271,271,271,271,271,271,271,285,227,280,280,280,280,280,280,280,280,280,280,280,280,280,280,280,280,280,280,280,280,280,280,280,280,280,280,280,280,280,280,280,280,280,280,280,280,280,225,286,271,271,271
271,271,271,271,271,271,271,271,271,240,317,280,280,280,280,280,280,280,280,280,280,315,316,241,271,271,271,271,271,271,271,271,271,271,271,271,271,285,227,280,280,280,280,280,280,280,280,280,280,280,280,280,280,280,280,280,280,280,280,280,280,280,280,280,280,280,280,280,280,280,280,280,280,280,225,286,271,271,271,271
271,271,271,271,271,271,271,271,271,272,280,280,280,280,280,280,280,280,280,280,280,280,280,315,241,271,271,271,271,271,271,271,271,271,271,271,271,271,285,226,226,227,280,280,280,280,280,280,407,280,280,280,280,280,280,280,280,280,280,280,280,280,280,280,280,280,280,280,280,280,280,280,280,225,286,271,271,271,271,271
316,241,271,271,271,271,271,271,240,317,280,280,280,280,280,280,280,280,280,280,280,280,280,280,315,316,241,271,271,271,271,271,271,271,271,271,271,271,271,271,271,285,226,227,280,280,280,280,280,280,360,360,280,280,280,280,280,280,280,280,407,360,280,280,280,280,405,361,406,280,280,280,225,286,271,271,271,271,271,271
280,315,241,271,271,271,271,271,285,227,280,280,280,280,280,280,280,280,280,280,280,280,280,280,280,280,315,316,241,271,271,271,271,271,271,271,271,271,240,316,241,271,271,285,226,227,280,280,280,280,280,405,280,280,280,280,280,280,280,280,362,280,280,280,280,405,406,280,280,280,280,225,286,271,271,271,271,271,271,271
280,280,270,271,271,271,271,271,271,272,280,280,280,280,280,280,280,280,280,280,280,280,280,280,280,280,280,280,315,316,316,316,316,316,241,271,271,271,285,226,286,271,271,271,271,285,226,227,280,280,280,280,280,280,280,280,280,280,280,280,280,280,280,280,280,280,280,280,280,280,225,286,271,271,271,271,271,271,271,271
280,280,315,241,271,271,271,271,271,285,227,280,280,280,280,280,280,280,280,280,280,280,280,280,280,280,280,280,280,280,280,280,280,407,315,316,316,316,241,271,271,271,271,271,271,271,271,285,227,280,280,280,280,280,280,280,280,280,280,280,280,280,280,280,280,280,280,280,225,226,286,271,271,271,271,271,271,240,316,316
280,280,280,315,241,271,271,271,271,271,272,280,280,280,280,280,280,280,280,280,280,280,280,280,280,280,280,280,280,280,280,280,280,280,362,360,280,280,315,316,316,241,271,271,271,271,271,271,285,226,227,280,280,280,280,280,280,280,280,280,280,280,280,280,280,280,280,225,286,271,271,271,271,271,271,271,240,317,280,280
280,280,280,280,315,241,271,271,271,271,285,227,280,280,280,280,280,280,280,280,280,280,280,280,280,280,280,280,280,280,280,280,280,280,280,280,406,406,280,280,280,270,271,271,271,240,241,271,271,271,285,226,227,280,280,280,280,280,280,280,280,280,280,280,280,280,280,270,271,271,271,271,271,271,240,316,317,280,280,280
280,280,280,280,280,315,241,271,271,271,271,272,280,280,280,280,280,280,280,280,280,280,280,280,280,280,280,280,280,280,280,280,280,280,280,280,280,362,362,280,280,315,241,271,271,285,286,271,271,271,271,271,272,280,280,280,280,407,280,280,280,280,280,280,280,225,226,286,271,271,271,271,240,316,317,280,280,280,280,280
