271,271,271,271,271,271,271,271,271,272,280,280,280,280,280,280,280,280,280,280,280,280,280,280,280,280,280,280,280,280,280,280,280,280,280,280,280,280,280,280,280,280,280,280,280,280,280,280,280,280,280,280,280,280,280,280,280,280,280,280,280,280,280,280,280,280,280,280,280,280,280,280,280,280,280,280,280,280,280,280
271,271,271,271,271,271,271,271,271,272,280,280,280,280,280,280,280,280,280,280,280,280,280,280,280,280,280,280,280,280,280,280,280,280,280,280,280,280,280,280,280,280,280,280,280,280,280,280,280,280,280,280,280,280,280,280,280,280,280,280,280,280,280,280,280,280,280,280,280,280,280,280,280,280,280,280,280,280,280,280
271,271,271,271,271,271,271,271,271,272,280,280,280,280,280,280,280,280,280,280,280,280,280,280,280,280,280,280,280,280,280,280,280,280,280,280,280,280,280,280,280,280,280,280,280,280,280,280,280,280,280,280,280,280,280,280,280,280,280,280,280,280,280,280,280,280,280,280,280,280,280,280,280,280,280,280,280,280,280,280
271,271,271,271,271,271,271,271,271,272,280,280,280,280,280,280,280,280,280,280,280,280,280,280,280,280,280,280,280,280,280,280,280,280,280,280,280,280,280,280,280,280,280,280,280,280,280,280,280,280,280,280,280,280,280,280,280,280,280,280,280,280,280,280,280,280,280,280,280,280,280,280,280,280,280,280,280,280,280,280
271,240,241,271,271,271,271,271,271,285,227,280,280,280,280,280,280,280,280,280,280,280,280,280,280,280,280,280,280,280,280,280,280,280,280,280,280,280,280,280,280,280,280,280,280,280,280,280,280,280,280,280,280,280,280,280,280,280,280,280,280,280,280,280,280,280,280,280,280,280,280,280,280,280,280,280,280,280,280,280
271,285,286,271,271,271,271,271,271,271,285,227,280,280,280,280,280,280,280,280,280,280,280,280,280,280,280,280,280,280,280,280,280,280,280,280,280,280,280,280,280,280,280,280,280,280,280,280,280,280,280,280,280,280,280,280,280,280,280,280,280,280,280,280,280,280,280,280,280,280,280,280,280,280,280,280,280,280,280,280
271,271,271,271,271,271,271,271,271,271,271,285,227,280,280,280,280,280,280,280,280,280,280,280,280,280,280,280,280,280,280,280,280,280,280,280,280,280,280,280,280,280,280,280,280,280,280,280,280,280,280,280,280,280,280,280,280,280,280,280,280,280,280,280,280,280,280,280,280,280,280,280,280,280,280,280,280,280,280,280
271,271,271,271,271,271,271,271,271,271,271,271,285,226,227,280,280,280,280,280,280,280,280,280,280,280,280,280,280,280,280,280,280,280,280,280,225,226,226,226,227,280,280,280,280,280,280,280,280,280,280,280,280,280,280,280,280,280,280,280,280,280,280,280,280,280,280,280,280,280,280,280,280,280,280,280,280,280,280,280
271,271,271,271,271,271,271,271,271,271,271,271,271,271,285,226,227,280,280,280,280,280,280,280,280,280,280,280,280,280,280,280,280,280,280,225,286,271,271,271,285,226,227,280,280,280,280,280,280,280,280,280,280,280,280,280,280,280,280,280,280,280,280,280,280,280,280,280,280,280,280,280,280,280,280,280,280,280,280,280
271,271,271,271,271,271,271,271,271,271,271,271,271,271,271,271,285,226,227,280,280,280,280,280,280,280,280,280,280,280,280,280,225,226,226,286,271,271,271,271,271,271,285,227,280,280,280,280,280,280,280,280,280,280,280,280,280,280,280,280,280,280,280,280,280,280,280,280,280,280,280,280,280,280,280,280,280,280,280,280
271,271,271,271,271,271,271,271,271,271,271,271,271,271,271,271,271,271,285,226,226,227,280,280,280,280,280,225,226,226,226,226,286,271,271,271,271,271,271,271,271,271,271,285,227,280,280,280,280,280,280,280,280,280,280,280,280,280,280,280,280,280,280,280,280,280,280,280,280,280,280,280,280,280,280,280,280,280,280,280
271,271,271,271,271,271,271,271,271,271,271,271,271,271,271,271,271,271,271,271,271,285,226,226,227,225,226,286,271,271,271,271,271,271,271,240,241,271,271,271,271,271,271,271,285,227,280,280,280,280,280,280,280,280,280,280,280,280,280,280,280,280,280,280,280,280,280,280,280,280,280,280,280,280,280,280,280,280,280,280
316,241,271,271,271,271,271,271,271,271,271,271,271,271,271,271,271,271,271,271,271,271,271,271,285,286,271,271,271,271,271,271,271,271,271,285,286,271,271,271,271,271,271,271,271,285,227,280,280,280,280,280,280,280,280,280,280,280,280,280,280,280,280,280,280,280,280,280,280,280,280,280,280,280,280,280,280,280,280,280
280,315,316,241,271,271,271,271,271,271,271,271,271,271,271,271,271,271,271,271,271,271,271,271,271,271,271,271,271,271,271,271,271,271,271,271,271,271,271,271,271,271,271,271,271,271,285,227,280,280,280,280,280,280,280,280,280,280,280,280,280,280,280,280,280,280,280,280,280,280,280,280,280,280,280,280,280,280,280,280
280,280,280,315,316,316,241,271,271,271,271,271,271,271,271,271,271,271,271,271,271,271,271,271,271,271,271,271,271,271,271,271,271,271,271,271,271,271,271,271,271,271,271,271,271,271,271,285,227,280,280,280,280,280,280,280,280,280,280,280,280,280,280,280,280,280,280,280,280,280,280,280,280,280,280,280,280,280,280,280
280,280,280,280,280,280,315,316,316,241,271,271,271,271,271,240,241,271,271,271,271,271,271,271,271,271,271,271,271,271,271,271,271,271,271,271,271,271,271,271,271,271,271,271,271,271,271,240,241,227,280,280,280,280,280,280,280,280,280,280,280,280,280,280,280,280,280,280,280,280,280,280,280,280,280,280,280,280,280,280
280,280,280,280,280,280,280,280,280,315,316,316,316,241,271,285,286,271,271,271,271,271,271,271,271,271,271,271,271,271,271,271,271,271,271,271,271,271,271,271,271,271,271,271,271,271,271,285,286,272,280,280,280,280,280,280,280,280,280,280,280,280,280,280,280,280,280,280,280,280,280,280,280,280,280,280,280,280,280,280
280,280,280,280,280,280,280,406,280,280,280,280,280,315,316,316,241,271,271,271,271,271,271,271,271,271,271,271,271,271,271,271,271,271,271,271,271,271,271,271,271,271,271,271,271,271,271,271,271,285,226,226,227,280,280,280,280,280,280,280,280,280,280,280,280,280,280,280,280,280,280,280,280,280,280,280,280,280,280,280
280,280,280,360,362,280,280,280,280,280,280,280,280,280,280,280,315,316,241,271,271,271,271,271,271,271,271,271,271,271,271,271,271,271,271,271,271,271,271,271,271,271,271,271,271,271,271,271,271,271,271,271,285,226,227,280,280,280,280,280,280,280,280,280,280,280,280,280,280,280,280,280,280,280,280,280,280,280,280,280
280,280,280,360,361,280,280,280,280,280,280,280,280,280,280,280,280,280,315,316,316,316,316,316,241,271,271,271,271,271,271,271,271,271,271,271,271,271,271,271,271,271,271,271,271,271,271,271,271,271,271,271,271,271,285,227,280,280,280,280,280,280,280,280,280,280,280,280,280,280,280,280,280,280,280,280,280,280,280,280
280,280,280,280,280,280,280,280,280,280,280,280,280,280,406,280,280,280,280,280,280,280,280,280,315,316,241,271,271,271,271,271,271,271,271,271,271,271,271,271,271,271,271,271,271,271,271,271,271,271,271,271,271,271,271,272,280,280,280,280,280,280,280,280,280,280,280,280,280,280,280,280,280,280,280,280,280,280,280,280
280,280,280,280,280,280,280,280,280,280,280,280,280,280,360,280,280,280,280,280,280,280,280,280,280,280,315,316,241,271,271,271,271,271,271,271,271,271,271,271,271,271,271,271,271,271,271,271,271,271,271,271,271,271,271,285,227,280,280,280,280,280,280,280,280,280,280,280,280,280,280,280,280,280,280,280,280,280,280,280
280,280,280,280,280,280,280,280,280,280,280,280,280,280,280,280,280,280,280,280,280,280,280,280,280,280,280,280,315,241,271,271,271,271,271,271,271,271,271,271,271,271,271,271,271,271,271,271,271,271,271,271,271,271,271,271,285,227,280,280,280,280,280,280,280,280,280,280,280,280,280,280,280,280,280,280,280,280,280,280
280,280,280,280,280,280,280,280,280,280,280,280,280,280,280,280,280,280,280,280,280,280,280,280,280,280,280,280,280,315,316,241,271,271,271,271,271,271,271,271,271,271,271,271,271,271,271,271,271,271,271,271,271,271,271,271,271,285,227,280,280,280,280,280,280,280,280,280,280,280,280,280,280,280,280,280,280,280,280,280
280,280,280,280,280,280,280,280,280,280,280,280,280,280,280,280,280,280,280,280,280,280,280,280,280,280,280,280,280,280,280,315,316,241,271,271,271,271,271,271,271,271,271,271,271,271,271,271,271,271,271,271,271,271,271,271,271,271,272,280,280,280,280,280,280,280,280,280,280,280,280,280,280,280,280,280,280,280,280,280
280,280,280,280,280,280,280,280,280,280,280,280,280,280,280,280,280,280,280,280,280,280,280,280,280,280,280,280,280,280,280,280,280,315,316,316,241,271,271,271,240,316,241,271,271,271,271,271,271,271,271,271,271,271,271,271,271,271,285,227,280,280,280,280,280,280,280,280,280,280,280,280,280,280,280,280,280,280,280,280
280,280,280,280,280,280,280,280,280,280,280,280,280,280,280,280,280,280,280,280,280,280,280,280,280,280,280,280,280,280,280,280,280,280,280,280,315,316,316,316,317,280,315,316,316,241,271,271,271,271,271,271,271,271,271,271,271,271,271,285,226,227,280,280,280,280,280,280,280,280,280,280,280,280,280,280,280,280,280,280
280,280,280,280,280,280,280,280,280,280,280,280,280,280,280,280,280,280,280,280,280,280,280,280,280,280,280,280,280,280,280,280,405,405,360,280,280,280,280,280,280,280,280,280,280,315,316,316,241,271,271,271,271,271,271,271,271,271,271,271,271,285,227,280,280,280,280,280,280,280,280,280,280,280,280,280,280,280,280,280
280,280,280,280,280,280,280,280,280,280,280,280,280,280,280,280,280,280,280,280,280,280,280,280,280,280,280,280,280,280,280,280,280,280,280,280,280,407,280,280,280,280,280,280,280,280,280,280,315,316,241,271,271,271,271,271,271,271,271,271,271,271,285,226,227,280,280,280,280,280,280,280,280,280,280,280,280,280,280,280
280,280,280,280,280,280,280,280,280,280,280,280,280,280,280,280,280,280,280,280,280,280,280,280,280,280,280,280,280,280,280,280,280,280,280,280,280,280,280,280,280,280,406,280,280,280,280,361,362,407,315,316,316,241,271,271,271,271,271,271,271,271,271,271,285,226,227,280,280,280,280,280,280,280,280,280,280,280,280,280
280,280,280,280,280,280,280,280,280,280,280,280,280,280,280,280,280,280,280,280,280,280,280,280,280,280,361,360,280,280,280,280,280,280,280,280,280,280,280,280,280,280,280,280,280,280,280,280,280,280,280,280,280,315,316,241,271,271,271,271,271,271,271,271,271,271,272,280,280,280,280,280,280,280,280,280,280,280,280,280
280,280,280,280,280,280,280,280,280,280,280,280,280,280,280,280,280,280,280,280,280,280,280,280,280,280,361,280,280,280,280,280,280,280,280,280,280,280,280,280,280,280,280,280,280,280,280,280,280,280,280,280,280,280,280,315,316,241,271,271,271,271,271,271,271,271,272,280,280,280,280,280,280,280,280,280,280,280,280,280
280,280,280,280,280,280,280,280,280,280,280,280,280,280,280,280,280,280,280,280,280,280,280,280,407,405,280,280,280,280,280,280,280,280,280,280,280,280,280,280,280,280,280,280,280,280,280,280,280,280,280,280,280,280,280,280,280,315,316,316,241,271,271,271,271,271,272,280,280,280,280,280,280,280,280,280,280,280,280,280
280,280,280,280,280,280,280,280,280,280,280,362,280,280,280,280,280,280,280,280,280,280,407,362,280,280,280,280,280,280,280,280,280,280,280,280,280,280,280,280,280,280,280,280,280,280,280,280,280,280,280,280,280,280,280,280,280,280,280,280,315,241,271,271,271,271,272,280,280,280,280,280,280,280,280,280,280,280,280,280
280,280,280,280,280,280,280,280,280,280,280,280,280,280,280,405,280,280,280,280,280,280,280,280,280,280,280,280,280,280,280,280,280,280,280,280,280,280,280,280,280,280,280,280,280,280,280,280,280,280,280,280,280,280,280,280,280,280,280,360,280,315,316,316,316,316,317,280,280,280,280,280,280,280,280,280,280,280,280,280
280,280,280,280,280,280,280,280,280,280,280,280,280,280,280,407,361,280,280,280,280,280,280,280,280,280,280,280,280,280,280,280,280,280,280,280,280,280,280,280,280,280,280,280,280,280,280,280,280,280,280,280,280,280,280,280,280,280,280,280,280,280,280,280,280,280,280,280,280,280,280,280,280,280,280,280,280,280,280,280
280,280,280,280,280,280,280,280,280,280,280,280,280,280,280,280,280,280,280,280,280,280,280,280,280,280,280,280,280,280,280,280,280,280,280,280,280,280,280,280,280,280,280,280,280,280,280,280,280,280,280,280,280,280,280,280,280,280,280,280,280,280,280,280,280,280,280,280,280,280,280,280,280,280,280,280,280,280,280,280
280,280,280,280,280,280,280,280,280,280,280,280,280,280,280,280,280,280,280,280,280,280,280,280,280,280,280,280,280,280,280,280,280,280,280,280,280,280,280,280,280,280,280,280,280,280,280,280,280,280,280,280,280,280,280,280,280,280,280,280,280,280,280,280,280,280,280,280,280,280,280,280,280,280,280,280,280,280,280,280
280,280,225,226,226,226,226,226,226,226,227,280,280,280,280,280,280,280,280,280,280,280,280,280,280,280,280,280,280,280,280,280,280,280,280,280,280,280,280,280,280,280,280,280,280,280,280,280,280,280,280,280,280,280,280,280,280,280,280,280,280,280,280,280,280,280,280,280,280,280,280,280,280,280,280,280,280,280,280,280
225,226,286,271,271,271,271,271,271,271,285,226,226,227,280,280,280,280,280,280,280,280,280,280,280,280,280,280,280,280,280,361,280,280,280,280,280,280,280,280,280,280,280,280,280,280,280,280,280,280,280,280,280,280,280,280,280,280,280,280,280,280,280,280,280,280,280,280,280,280,280,280,280,280,280,280,280,280,280,280
286,271,240,316,316,241,271,240,241,271,271,271,271,285,226,227,280,280,280,280,280,280,280,280,280,280,280,280,280,280,280,280,407,280,280,280,280,280,280,280,280,280,280,280,280,280,280,280,280,280,280,280,361,280,280,280,280,280,280,280,280,280,280,280,280,280,280,280,280,280,280,280,280,280,280,280,280,280,280,280
271,271,285,226,226,286,271,285,286,271,271,240,241,271,271,285,226,226,227,280,280,280,280,280,280,280,280,280,280,280,280,280,280,280,280,280,280,280,280,280,280,280,280,280,280,280,280,280,280,280,280,280,280,280,280,280,280,280,280,280,280,280,280,280,280,280,280,280,280,280,280,280,280,280,280,280,280,280,280,280
271,271,271,271,271,271,271,271,271,271,271,285,286,271,271,271,271,271,285,227,280,280,280,280,280,280,280,280,280,280,280,280,280,280,280,280,405,280,280,280,280,280,280,280,280,280,280,280,280,280,280,405,280,280,280,280,280,280,280,280,280,280,280,280,280,280,280,280,280,280,280,280,280,280,280,280,280,280,280,280
271,271,271,271,271,271,271,271,271,271,271,271,271,271,240,316,241,271,271,285,227,280,280,280,280,280,280,280,280,280,280,280,280,280,280,280,280,280,280,280,280,280,280,280,280,280,280,280,280,280,280,407,280,280,280,280,280,280,280,280,280,280,280,280,280,280,280,280,280,280,280,280,280,280,280,280,280,280,280,280
271,271,271,271,271,271,271,271,271,271,271,271,271,271,285,226,286,271,271,271,285,227,280,280,280,280,280,280,280,280,280,280,280,280,280,280,280,280,280,280,280,280,280,280,280,280,280,280,280,280,280,360,280,280,280,280,280,280,280,280,280,280,280,280,280,280,280,280,280,280,280,280,280,280,280,280,280,280,280,280
271,271,271,271,271,271,271,271,271,271,271,271,271,271,271,271,271,271,271,271,271,272,280,280,280,280,280,280,280,280,280,280,280,280,280,280,280,280,280,280,280,280,280,280,280,280,280,280,280,280,280,361,280,280,280,280,280,280,280,280,280,280,280,280,280,280,280,280,280,280,280,280,280,280,280,280,280,280,280,280
271,271,271,271,271,271,271,271,271,271,271,271,271,271,271,271,271,271,271,271,271,285,227,280,280,280,280,361,280,280,280,280,280,280,280,280,280,280,280,280,280,280,280,280,406,280,280,280,280,280,280,406,280,280,280,280,280,280,280,280,280,280,280,280,280,280,280,280,280,280,280,280,280,280,280,280,280,280,280,280
271,271,271,271,271,271,271,271,271,271,271,271,271,271,271,271,271,271,271,271,271,271,285,227,280,280,280,361,362,280,280,280,280,280,280,280,280,280,280,280,280,280,280,406,361,280,280,280,280,280,407,280,280,280,280,280,280,280,280,280,280,280,280,280,280,280,280,280,280,280,280,280,280,280,280,280,280,280,280,280
271,271,271,271,240,241,271,271,271,271,271,271,271,271,271,271,271,271,271,271,271,271,271,285,227,280,280,280,280,280,280,280,280,280,405,280,280,280,280,280,280,280,280,280,405,280,280,280,280,280,361,280,280,280,280,280,280,280,280,280,280,280,280,280,280,280,280,280,280,280,280,280,280,280,280,280,280,280,280,280
271,271,271,271,285,286,271,271,271,271,271,271,271,271,271,271,271,271,271,271,271,271,271,271,272,280,280,280,280,280,280,280,280,280,362,280,280,280,280,280,280,280,280,280,280,280,280,280,280,362,280,280,280,280,280,280,280,280,280,280,280,280,280,280,280,280,280,280,280,280,280,280,280,280,280,280,280,280,280,280
316,316,316,316,241,271,271,271,271,271,271,271,271,271,271,271,271,271,271,271,271,271,271,271,285,227,280,280,280,280,280,280,280,280,280,405,280,280,280,280,280,280,280,280,280,280,280,280,280,280,280,280,280,280,280,280,280,280,280,280,280,280,280,280,280,280,280,280,280,280,280,280,280,280,280,280,280,280,280,280
280,280,360,405,315,316,316,241,271,271,271,271,271,271,271,271,271,271,271,271,271,271,271,271,271,272,280,280,280,280,280,280,280,280,406,362,406,280,280,280,280,280,280,280,280,280,280,280,280,280,280,280,280,280,280,280,280,280,280,280,280,280,280,280,280,280,280,280,280,280,280,280,280,280,280,280,280,280,280,280
280,280,280,361,405,280,280,315,241,271,271,271,271,271,271,271,271,271,271,271,271,271,271,271,271,285,227,280,280,280,280,280,280,280,280,280,280,280,280,280,280,280,280,280,280,280,280,280,280,280,280,280,280,280,280,280,280,280,280,280,280,280,280,280,280,280,280,280,280,280,280,280,280,280,280,280,280,280,280,280
280,280,280,280,362,280,280,280,315,241,271,271,271,271,271,271,271,271,271,271,271,271,271,271,271,271,272,280,280,280,280,280,280,280,280,280,405,280,280,280,280,280,280,280,280,407,280,280,280,280,280,280,280,280,280,280,280,280,280,280,280,280,280,280,280,280,280,280,280,280,280,280,280,280,280,280,280,280,280,280
227,280,280,280,362,280,280,280,280,270,271,271,271,271,271,271,271,271,271,271,271,271,271,271,271,271,272,280,280,280,280,280,280,280,280,280,280,280,280,280,280,280,280,280,280,280,280,280,280,280,280,280,280,280,280,280,280,280,280,280,280,280,280,280,280,280,280,280,280,280,280,280,280,280,280,280,280,280,280,280
285,226,226,226,227,280,280,280,280,270,271,240,241,271,271,271,271,240,241,271,271,271,271,271,271,271,285,227,280,280,280,280,280,280,280,280,280,280,280,280,280,280,280,280,280,280,280,280,280,280,280,280,280,280,280,280,280,280,280,280,280,280,280,280,280,280,280,280,280,280,280,280,280,280,280,280,280,280,280,280
271,271,271,271,285,226,227,280,280,270,271,272,270,271,271,271,271,285,286,271,271,271,271,271,271,271,271,272,280,280,280,280,280,280,280,280,280,280,280,280,280,280,280,280,280,280,280,280,280,280,280,280,280,280,280,280,280,280,280,280,280,280,280,280,280,280,280,280,280,280,280,280,280,280,280,280,280,280,280,280
271,271,271,271,271,271,285,227,360,280,271,285,286,271,271,271,271,271,271,271,271,271,271,271,271,240,241,272,280,280,280,280,280,280,280,280,280,280,280,280,280,280,280,280,280,280,280,280,280,280,280,280,280,280,280,280,280,280,280,280,280,280,280,280,280,280,280,280,280,280,280,280,280,280,280,280,280,280,280,280
271,271,271,240,241,271,271,272,406,280,271,271,271,271,271,271,271,271,271,271,271,271,271,271,271,285,286,272,280,280,280,280,280,280,280,280,280,280,280,280,280,280,280,280,280,280,280,280,280,280,280,280,280,280,280,280,280,280,280,280,280,280,280,280,280,280,280,280,280,280,280,280,280,280,280,280,280,280,280,280
271,271,271,272,270,271,271,272,280,280,271,271,271,271,271,271,271,271,271,271,271,271,271,271,271,271,271,285,227,280,280,280,280,280,280,280,280,280,280,280,361,362,280,280,280,280,280,280,280,280,280,280,280,280,280,280,280,280,280,280,280,280,280,280,280,280,280,280,280,280,280,280,280,280,280,280,280,280,280,280
271,271,271,272,270,271,271,272,280,280,271,271,271,271,271,271,271,271,271,271,271,271,271,271,271,271,271,271,272,280,280,280,280,280,280,280,280,280,280,280,360,361,280,280,280,280,280,280,280,280,280,280,280,280,280,280,280,280,280,280,280,280,280,280,280,280,280,280,280,280,280,280,280,280,280,280,280,280,280,280
271,271,271,285,286,271,271,272,280,280,271,271,271,271,271,271,271,271,271,271,271,271,271,271,271,271,271,271,272,280,280,280,280,280,280,280,280,280,280,280,280,280,280,280,280,360,280,280,280,280,280,280,280,280,280,280,280,280,280,280,280,280,280,280,280,280,280,280,280,280,280,280,280,280,280,280,280,280,280,280
271,271,271,271,271,271,271,272,280,280,271,271,271,271,271,271,271,271,271,271,271,271,271,271,271,271,271,271,272,280,280,280,280,280,280,280,280,280,280,280,280,280,280,280,280,280,280,280,280,280,280,280,280,280,280,280,280,280,280,280,280,280,280,280,280,280,280,280,280,280,280,280,280,280,280,280,280,280,280,280
271,271,271,271,271,271,271,272,280,280,271,271,271,271,271,271,271,271,271,271,271,271,271,271,271,271,271,271,272,280,280,280,280,280,280,280,280,280,280,280,280,280,280,280,280,280,280,280,280,280,280,280,280,280,280,280,280,280,280,280,280,280,280,280,280,280,280,280,280,280,280,280,280,280,280,280,280,280,280,280
271,271,271,271,271,271,271,272,280,270,271,240,241,271,271,271,271,271,271,271,271,271,271,271,271,240,241,271,272,280,280,280,280,280,406,280,280,280,280,280,280,280,280,280,280,280,280,280,280,280,280,280,280,280,280,280,280,280,280,280,280,280,280,280,280,280,280,280,280,280,280,280,280,280,280,280,280,280,280,280
271,271,271,271,271,271,240,317,280,270,271,285,286,271,271,271,271,271,271,271,271,271,271,271,271,272,270,271,272,280,280,280,280,280,407,280,280,280,280,280,280,280,280,280,280,280,280,280,280,280,280,280,280,280,280,280,280,280,280,280,280,280,280,280,280,280,280,280,280,280,280,280,280,280,280,280,280,280,280,280
271,271,271,271,271,240,317,280,280,270,271,271,271,271,271,271,271,271,271,271,271,271,271,271,271,272,270,271,272,280,280,280,280,280,280,280,280,280,280,280,280,280,280,280,280,280,280,280,280,280,280,280,280,280,280,280,280,280,280,280,280,280,280,280,280,280,280,280,280,280,280,280,280,280,280,280,280,280,280,280
271,271,271,271,271,272,280,280,280,270,271,271,271,271,271,271,271,271,271,271,271,271,271,271,271,272,270,271,272,280,280,280,280,280,280,280,280,280,280,280,280,280,280,280,280,280,280,280,280,280,280,280,280,280,280,280,280,280,280,280,280,280,280,280,280,280,280,280,280,280,280,280,280,280,280,280,280,280,280,280
271,271,240,241,271,272,280,280,280,315,241,271,271,271,271,271,271,271,271,271,271,271,271,271,271,285,286,240,317,280,280,280,280,280,280,280,280,280,280,280,280,280,280,280,280,280,280,280,280,280,280,280,280,280,280,280,280,280,280,280,280,280,280,280,280,280,280,280,280,280,280,280,280,280,280,280,280,280,280,280
271,271,285,286,271,272,280,280,280,280,270,271,271,271,271,271,271,271,271,271,271,271,271,271,271,271,271,272,280,280,280,280,280,280,280,280,280,280,280,280,280,280,280,280,280,280,280,280,280,280,280,280,280,280,280,280,280,280,280,280,280,280,280,280,280,280,280,280,280,280,280,280,280,280,280,280,280,280,280,280
271,271,271,271,271,272,280,280,280,225,286,271,271,271,271,271,271,271,271,271,271,271,271,271,271,271,240,317,280,280,280,280,280,280,280,280,280,280,280,280,280,280,280,280,280,280,280,280,280,280,280,280,280,280,280,280,280,280,280,280,280,280,280,280,280,280,280,280,280,280,280,280,280,280,280,280,280,280,280,280
271,271,271,271,240,317,280,280,280,270,271,271,271,271,271,271,271,271,271,271,271,271,271,271,271,271,272,280,280,280,280,280,280,280,280,280,280,280,280,280,280,280,280,280,280,280,280,280,280,280,280,280,280,280,280,280,280,280,280,280,280,280,280,280,280,280,280,280,280,280,280,280,280,280,280,280,280,280,280,280
271,271,271,240,317,280,280,280,225,286,271,240,241,271,271,271,271,271,271,271,271,271,271,271,240,316,317,280,280,280,280,280,280,280,280,280,280,280,280,280,280,280,280,280,280,280,280,280,280,280,280,280,280,280,280,280,280,280,280,280,280,280,280,280,280,280,280,280,280,280,280,280,280,280,280,280,280,280,280,280
271,271,240,317,280,280,280,225,286,271,271,285,286,271,271,271,271,271,271,271,271,271,271,240,317,280,280,280,280,280,280,361,280,280,280,280,280,280,280,280,280,280,280,280,280,280,280,280,280,280,280,280,280,280,280,280,280,280,280,280,280,280,280,280,280,280,280,280,280,280,280,280,280,280,280,280,280,280,280,280
271,240,317,280,280,280,280,270,271,271,271,271,271,271,271,271,271,271,271,271,271,271,240,317,280,280,280,362,280,280,407,280,280,280,280,280,280,280,280,280,280,280,280,280,280,280,280,280,280,280,280,280,280,280,280,280,280,280,280,280,280,280,280,280,280,280,280,280,280,280,280,280,280,280,280,280,280,280,280,280
240,317,280,280,280,280,280,270,271,271,271,271,271,271,271,271,271,271,271,271,240,316,317,280,280,280,280,406,406,362,280,280,280,280,280,280,280,280,280,280,280,280,280,280,280,280,280,280,280,280,280,280,280,280,280,280,280,280,280,280,280,280,280,280,280,280,280,280,280,280,280,280,280,280,280,280,280,280,280,280
317,280,280,280,280,280,280,270,271,271,271,271,271,271,271,271,271,271,271,271,272,280,280,280,280,280,280,280,280,280,280,280,280,280,280,280,280,280,280,280,280,280,280,280,280,280,280,280,280,280,280,280,280,280,280,280,280,280,280,280,280,280,280,280,280,280,280,280,280,280,280,280,280,280,280,280,280,280,280,280
280,280,280,280,280,280,280,270,271,271,271,271,271,271,271,271,271,271,271,271,272,280,280,280,280,280,280,280,280,280,280,280,280,280,280,280,280,280,280,280,280,280,280,280,280,280,280,280,280,280,280,280,280,280,280,280,280,280,280,280,280,280,280,280,280,280,280,280,280,280,280,280,280,280,280,280,280,280,280,280
280,280,280,280,280,280,280,315,316,241,271,271,271,271,271,271,271,271,271,271,272,280,280,280,280,280,280,280,280,280,280,280,280,280,280,280,280,280,280,280,280,280,280,280,280,280,280,280,280,280,280,280,280,280,280,280,280,280,280,280,280,280,280,280,280,280,280,280,280,280,280,280,280,280,280,280,280,280,280,280
280,280,280,280,280,280,280,280,225,286,271,271,271,271,271,271,271,240,316,316,317,280,280,280,280,280,280,280,280,280,280,280,280,280,280,280,280,280,280,280,280,280,280,280,280,280,280,280,280,280,280,280,280,280,280,280,280,280,280,280,280,280,280,280,280,280,280,280,280,280,280,280,280,280,280,280,280,280,280,280
