240,317,280,280,280,280,280,362,360,280,280,280,280,280,280,280,406,280,280,280,280,280,280,280,280,280,280,280,280,280,280,406,405,405,280,405,280,280,280,280,280,280,280,280,280,280,280,280,280,280,280,280,280,280,280,280,280,280,280,280,280,280,280,280,280,280,280,280,280,280,280,280,280,280,280,315,241,271,271,271
317,280,280,280,280,280,280,280,280,280,280,280,280,280,280,280,280,280,280,280,280,280,280,280,280,280,280,280,280,280,280,361,361,280,280,280,405,280,280,280,280,280,280,280,280,280,280,280,280,280,280,280,280,280,280,280,280,280,280,280,280,280,280,280,280,280,280,280,280,280,280,280,280,280,280,280,315,241,271,271
280,280,280,280,280,280,280,280,280,280,280,280,280,280,280,280,280,280,280,280,280,280,280,280,280,280,280,280,280,280,280,407,280,280,280,280,362,280,280,280,280,280,280,280,280,280,280,280,280,280,280,280,280,280,280,280,280,280,280,280,280,280,280,280,280,280,280,280,280,280,280,280,280,280,280,280,280,315,241,271
280,280,280,280,280,280,280,280,280,280,280,280,280,280,280,280,280,280,280,280,280,280,280,280,362,280,280,280,280,361,361,280,280,280,280,280,360,280,280,280,280,280,280,280,280,280,280,280,280,280,280,280,280,280,280,280,280,280,280,280,280,280,280,280,280,280,280,280,280,280,280,280,280,280,280,280,280,280,315,241
280,280,280,280,280,280,280,280,280,280,280,280,280,280,280,280,280,280,280,280,280,280,280,280,280,280,280,280,280,280,280,280,280,280,280,280,407,280,280,362,280,280,280,280,280,280,280,280,280,280,280,280,280,280,280,280,280,280,280,280,280,280,280,280,280,280,280,280,280,280,280,280,280,280,280,280,280,280,280,315
280,280,280,280,280,280,280,280,280,280,361,280,280,280,280,280,280,280,280,280,280,280,280,280,280,280,280,280,280,280,280,280,280,280,280,280,280,280,280,406,280,280,280,280,280,280,280,280,280,280,280,280,280,280,280,280,280,280,280,280,280,280,280,280,280,280,280,280,280,280,280,280,280,280,280,280,280,280,280,280
280,280,280,280,280,280,280,280,280,280,360,280,280,280,280,280,280,280,280,280,280,280,280,280,280,280,280,280,280,280,280,280,280,280,280,280,280,280,280,280,280,280,280,280,280,280,280,280,280,280,280,280,280,280,280,280,280,280,280,280,280,280,280,280,280,280,280,280,280,280,280,280,280,280,280,280,280,280,280,280
280,280,280,280,280,280,280,280,280,280,280,280,280,280,280,280,280,280,280,280,280,280,280,280,360,280,280,280,280,280,280,280,280,280,280,280,280,280,280,280,280,280,280,280,280,280,280,280,280,280,280,280,280,280,280,280,280,280,280,280,280,280,280,280,280,280,280,280,280,280,280,280,280,280,280,280,280,280,280,280
280,407,280,280,280,280,280,280,280,280,280,280,280,280,280,280,280,280,280,280,280,280,280,362,361,280,280,280,280,280,280,280,280,280,280,280,280,280,280,280,280,280,280,280,280,280,280,280,280,280,280,280,280,280,280,280,280,280,280,280,280,280,280,280,280,280,280,280,280,280,280,280,280,280,280,280,280,280,280,280
361,280,280,280,280,280,280,406,280,280,280,280,280,280,280,280,280,280,280,280,280,280,362,280,280,280,280,280,280,280,280,407,280,280,280,280,280,280,280,280,280,280,280,280,280,280,280,280,280,280,280,280,280,280,280,280,280,280,280,280,280,280,280,280,280,280,280,280,280,280,280,280,280,280,280,280,280,280,280,280
407,280,280,280,280,280,280,280,280,280,280,280,280,280,280,361,362,406,280,280,280,405,280,280,280,280,280,280,280,280,280,280,280,280,280,280,280,280,280,360,280,280,280,280,280,280,280,280,280,280,280,280,280,280,280,280,280,280,280,280,280,280,280,280,280,280,280,280,280,280,280,280,280,280,280,280,280,280,280,280
406,280,280,280,280,280,280,280,280,280,361,407,280,280,280,280,280,280,362,362,405,280,280,280,280,280,405,280,280,280,280,280,280,361,280,280,280,280,280,280,280,280,280,280,280,280,280,280,280,280,280,280,280,280,280,280,280,280,280,280,280,280,280,280,280,280,280,280,280,280,280,280,280,280,280,280,280,280,280,280
360,280,280,280,280,280,280,280,280,280,280,280,280,280,280,280,280,280,280,280,280,280,280,280,280,280,280,280,280,280,280,280,280,280,280,280,280,280,280,280,280,280,280,280,280,280,280,280,280,280,280,280,280,280,280,280,280,280,280,280,280,280,280,280,280,280,280,280,280,225,226,227,280,280,280,280,280,280,280,280
407,280,280,280,280,280,280,280,280,280,280,280,280,280,280,280,280,280,280,280,280,280,280,280,280,280,280,280,280,280,280,280,280,280,280,280,280,280,280,280,280,280,280,280,280,280,280,280,280,280,280,280,280,280,280,280,280,280,280,280,280,280,280,280,280,280,280,280,280,270,271,285,227,280,280,280,280,280,280,280
406,280,280,280,280,280,280,280,280,280,280,280,280,280,280,280,280,280,280,280,280,280,280,280,280,280,280,280,280,280,280,280,280,280,280,280,280,280,280,280,280,280,280,280,280,280,280,280,280,280,280,280,280,280,280,280,280,280,280,280,280,280,280,280,280,280,280,280,280,270,271,271,285,227,280,280,280,280,280,280
406,280,280,280,280,280,280,280,280,280,280,280,280,280,280,280,280,280,280,280,280,280,280,361,407,362,280,280,280,280,280,280,280,280,280,361,361,406,280,280,280,280,280,280,280,280,280,280,280,280,280,280,280,280,280,280,280,280,280,280,280,280,280,280,280,280,280,280,280,270,271,271,271,272,280,280,280,280,280,280
361,280,280,280,280,280,280,406,280,280,280,280,280,280,280,280,280,280,280,280,406,362,360,361,280,280,280,280,280,280,280,280,280,280,406,407,280,280,280,280,280,280,280,280,280,280,280,280,280,280,280,280,280,280,280,280,280,280,280,280,280,280,280,280,280,280,280,280,280,270,271,271,271,285,227,280,280,280,228,230
280,280,280,280,280,280,280,280,280,280,280,280,280,280,280,280,280,280,362,406,280,280,280,280,280,280,280,280,280,280,280,360,360,406,280,280,280,280,280,280,280,280,280,280,280,280,280,280,280,280,280,280,280,280,280,280,280,280,280,280,280,280,280,280,280,280,225,226,226,286,271,271,271,271,285,226,226,227,273,287
280,280,280,280,280,280,280,280,280,280,280,280,280,280,280,280,280,280,280,280,280,280,280,280,280,280,361,361,280,280,280,405,280,280,280,280,280,280,280,280,280,280,280,280,280,280,280,280,280,280,280,280,280,280,280,280,280,280,280,280,280,280,280,280,280,280,270,271,271,271,271,271,271,271,271,271,271,272,318,243
280,280,280,280,361,280,280,280,280,280,280,280,280,280,280,280,280,280,280,280,280,280,280,280,361,406,362,280,280,280,280,280,280,280,280,280,280,280,280,280,280,280,280,280,280,280,280,280,280,280,280,280,280,280,280,280,280,280,280,280,280,280,280,280,280,225,286,271,271,271,271,271,271,271,271,271,271,285,227,318
280,280,280,280,280,280,280,280,280,280,280,280,280,280,280,280,280,280,280,280,280,280,280,360,280,280,280,280,280,280,280,280,280,280,280,280,280,280,280,280,280,280,280,280,280,280,280,280,280,280,280,280,280,280,280,280,280,280,280,280,280,280,280,280,225,286,271,271,271,271,271,271,271,271,271,271,271,271,285,227
280,280,280,280,280,280,280,280,280,280,280,280,280,280,280,280,280,280,280,280,407,361,405,280,280,280,280,280,280,280,280,280,280,280,280,280,280,280,280,280,280,280,280,280,280,280,280,280,280,280,280,280,280,280,280,280,280,280,280,280,280,280,280,280,270,271,271,271,271,271,271,271,271,271,271,271,271,271,271,272
280,280,280,280,280,280,280,280,280,280,280,280,280,280,280,280,361,361,361,407,362,280,280,280,280,280,280,280,280,280,280,280,280,280,280,280,280,280,280,280,280,280,280,280,280,280,280,280,280,280,280,280,280,280,280,280,280,280,280,280,280,280,280,280,270,271,271,271,271,271,271,271,271,271,271,271,271,271,271,285
280,280,280,280,280,280,280,280,280,280,280,280,280,280,280,280,280,280,280,280,280,280,280,280,280,280,280,280,280,280,280,280,280,280,280,280,280,280,280,280,280,280,280,280,280,280,280,280,280,280,280,280,280,280,280,280,280,280,280,280,280,280,280,280,270,271,271,271,271,271,271,271,271,271,271,271,271,271,271,271
280,280,280,407,280,280,280,280,405,407,280,280,280,280,280,280,280,280,280,280,280,280,280,280,280,280,280,280,280,280,280,280,280,280,280,280,280,280,280,280,280,280,280,280,280,280,280,280,280,280,280,280,280,280,280,280,280,280,280,280,280,228,229,230,270,271,271,271,271,271,271,271,271,271,271,271,271,271,240,241
280,280,280,280,280,280,360,406,280,280,280,280,280,280,280,280,280,280,280,280,280,280,280,280,280,280,280,280,280,280,280,280,280,280,280,280,280,280,280,280,280,280,280,280,280,280,280,280,280,280,280,280,280,280,280,280,280,280,280,228,229,288,274,275,270,271,271,271,271,271,271,271,271,271,271,271,271,271,285,286
280,280,280,280,360,405,280,280,280,280,280,280,280,280,280,280,280,280,280,280,280,280,280,280,280,280,280,280,280,280,280,280,280,280,280,280,280,280,280,280,280,280,280,280,280,280,280,280,280,280,280,280,280,280,280,280,280,280,280,318,319,319,319,320,315,241,271,271,271,271,271,271,271,271,271,271,271,271,271,271
280,280,361,405,407,280,280,280,280,362,280,280,280,280,280,280,280,280,280,280,280,280,280,280,280,280,280,280,280,280,280,280,280,280,280,280,280,280,280,280,280,280,280,280,280,280,280,280,280,280,280,280,280,280,280,280,225,226,226,226,226,226,227,-1,225,286,271,271,271,271,271,271,271,271,271,271,271,271,271,271
280,280,280,280,280,280,280,280,407,360,280,280,280,280,280,280,280,280,280,280,280,280,280,280,280,280,280,280,280,280,280,280,280,280,280,280,280,280,280,280,280,280,280,280,280,280,280,280,280,280,280,280,225,226,226,226,286,271,271,271,271,271,285,226,286,271,271,271,271,271,271,271,271,271,271,271,271,271,271,271
280,280,280,280,280,280,280,280,280,280,280,280,280,280,280,280,280,280,280,280,280,280,280,280,280,280,280,280,280,280,280,280,280,280,280,280,280,280,280,280,280,280,280,280,280,280,280,280,225,226,226,226,286,271,271,271,271,271,271,271,271,271,271,271,271,271,271,271,271,271,271,271,271,271,271,271,240,316,316,316
280,280,280,280,280,280,280,280,280,280,280,280,280,280,280,280,280,280,280,280,280,280,280,280,280,280,280,280,280,280,280,280,280,280,280,280,280,280,280,280,280,280,280,280,280,280,225,226,286,271,271,271,271,271,271,271,271,271,271,271,271,271,271,271,271,271,271,271,271,271,240,316,316,316,316,316,317,280,280,280
280,280,280,280,280,280,280,280,280,280,280,280,280,280,280,280,280,280,280,280,280,280,280,280,280,280,280,280,280,280,280,280,280,280,280,280,280,280,280,280,280,280,280,280,225,226,286,271,271,271,271,271,271,271,271,271,271,271,271,271,271,271,271,271,271,240,316,316,316,316,317,280,280,280,280,280,280,280,280,280
407,280,280,280,280,280,280,280,280,280,280,280,280,280,280,280,280,280,280,280,280,280,280,280,280,280,280,280,280,280,280,280,280,280,280,280,280,280,280,280,280,280,280,225,286,271,271,271,271,271,271,271,271,271,271,271,271,271,271,240,316,316,316,316,316,317,280,280,280,280,280,280,280,280,280,280,280,280,280,280
280,280,280,280,280,280,280,280,280,280,280,280,280,280,280,280,280,280,280,280,280,280,280,280,280,280,280,280,280,280,280,280,280,280,280,280,280,280,280,280,225,226,226,286,271,271,271,271,271,271,271,271,271,271,271,271,271,271,240,317,280,280,280,280,280,280,280,280,280,280,280,280,280,280,280,280,280,280,280,280
280,280,280,280,280,280,280,280,280,280,280,280,280,280,280,280,280,280,280,280,280,280,280,280,280,280,280,280,280,280,280,280,280,280,280,280,225,226,226,226,286,271,271,271,271,271,271,271,271,271,271,271,271,271,271,240,316,316,317,280,280,280,280,280,280,280,280,280,280,280,407,360,280,280,280,280,280,280,280,280
280,280,280,280,280,280,280,280,280,280,280,280,280,280,280,280,280,280,280,280,280,280,280,280,280,280,280,280,280,280,280,280,280,280,280,225,286,271,271,271,271,271,271,271,271,271,271,271,271,271,271,271,271,240,316,317,280,280,280,280,280,280,280,280,280,280,280,280,280,280,280,280,280,280,280,280,280,280,280,280
280,280,280,280,280,280,280,280,280,280,280,280,280,280,280,280,280,280,280,280,280,280,280,280,280,280,280,280,280,280,280,280,280,225,226,286,271,271,271,271,271,271,271,271,271,271,271,271,271,271,240,316,316,317,280,280,280,280,280,280,280,280,280,280,280,407,361,280,280,280,280,280,280,280,280,280,280,280,280,280
280,280,280,280,280,280,280,280,280,280,280,280,280,280,280,280,280,280,280,280,280,280,280,280,280,280,280,280,280,280,280,225,226,286,271,271,271,271,271,271,271,271,271,271,271,271,271,240,316,316,317,280,280,280,280,280,280,280,280,280,280,280,280,280,280,405,280,280,280,406,360,280,280,280,280,280,280,280,280,280
280,280,280,280,280,280,280,280,280,280,280,280,280,280,280,280,280,280,280,280,280,280,280,280,280,280,280,280,280,280,280,270,271,271,271,271,271,271,271,271,271,240,316,316,316,316,316,317,280,280,280,280,280,280,280,405,280,280,280,280,280,280,280,280,280,280,280,280,280,280,280,280,280,280,280,280,280,280,280,280
280,280,280,280,280,280,280,280,280,280,280,280,280,280,280,280,280,280,280,280,280,280,280,280,280,280,280,280,280,225,226,286,271,271,271,271,271,271,240,316,316,317,280,280,280,280,280,280,280,280,280,280,280,280,280,280,280,280,280,280,280,280,280,280,280,280,280,280,280,280,280,280,280,280,280,280,280,280,280,406
280,280,280,280,280,280,280,280,280,280,280,280,280,280,280,280,280,280,280,280,280,280,280,280,280,280,280,280,225,286,271,271,271,271,271,271,271,271,272,280,280,280,280,280,280,280,280,280,280,280,280,280,280,280,280,280,280,280,280,280,280,280,280,280,280,280,280,280,280,280,280,280,280,280,280,280,280,361,405,406
280,280,280,280,280,280,280,280,280,280,280,280,280,280,280,280,280,280,280,280,280,280,280,280,280,280,280,280,270,271,271,271,271,271,271,271,271,271,272,280,280,280,280,280,280,280,280,280,280,280,280,280,280,280,280,405,280,280,280,280,280,280,280,280,280,280,280,280,280,280,407,405,280,280,361,406,280,280,280,280
280,280,280,280,280,280,280,280,280,280,280,280,280,280,280,280,280,280,280,280,280,280,280,280,280,280,280,280,315,316,316,316,316,316,316,241,271,271,272,280,280,280,280,280,280,280,280,280,280,280,280,280,280,280,280,280,280,280,280,280,280,280,280,280,280,407,280,280,280,280,280,406,280,280,280,280,280,280,280,280
280,280,280,280,280,280,280,280,280,280,280,280,280,280,280,280,280,280,280,280,280,280,280,280,280,280,280,280,280,280,280,280,280,280,280,315,316,316,317,280,280,280,280,280,280,280,280,280,280,280,407,280,280,280,280,280,280,280,280,280,280,280,280,280,280,360,280,280,280,280,280,407,280,280,280,280,280,280,280,280
280,280,280,280,280,280,280,280,280,280,280,280,280,280,280,280,280,280,280,280,280,280,280,280,280,280,280,280,280,280,280,280,280,280,280,280,280,280,280,280,280,280,280,280,280,280,280,280,280,280,280,280,280,280,280,280,280,406,280,280,280,280,280,280,280,406,360,280,362,280,280,362,280,280,280,280,280,280,280,280
280,280,280,280,280,280,280,280,280,280,280,280,280,280,280,280,280,280,280,280,280,280,280,280,280,280,280,280,280,280,280,280,280,280,280,280,280,280,280,280,406,280,280,280,280,280,280,280,280,280,280,280,280,280,280,280,280,280,280,280,280,280,280,280,280,280,280,280,280,280,280,280,280,280,280,280,280,280,280,280
280,280,280,280,280,280,280,280,280,280,280,280,280,280,280,280,280,280,280,280,280,280,280,280,280,280,280,280,280,280,280,280,280,280,280,280,280,280,280,280,360,280,361,280,280,280,280,280,280,280,280,280,280,280,280,280,280,280,280,280,280,280,280,280,280,280,280,280,280,280,280,280,280,280,280,280,280,280,280,280
280,280,280,280,280,280,280,280,280,280,280,280,280,280,280,280,280,280,280,280,407,280,280,280,280,280,280,280,280,280,280,280,280,280,280,280,280,280,280,361,280,280,361,280,280,280,280,280,280,280,280,280,280,280,280,280,280,280,280,280,280,280,280,280,280,280,280,280,280,280,280,280,280,280,280,280,280,280,280,280
280,280,280,280,280,280,280,280,280,280,280,280,280,280,280,280,280,280,280,280,360,280,280,280,280,280,280,280,280,280,280,280,280,280,280,280,280,406,362,280,280,280,407,280,280,280,280,280,280,280,280,280,280,280,280,280,280,280,280,280,280,280,280,280,280,280,280,280,280,280,280,280,280,280,280,361,280,280,280,280
280,280,280,280,280,280,280,280,280,280,280,280,280,280,280,280,280,280,280,407,406,280,280,280,280,407,280,280,280,280,280,280,280,280,280,280,280,405,360,280,280,280,361,280,280,280,280,280,280,280,280,280,280,280,280,280,280,280,280,280,280,280,280,280,280,280,280,280,280,280,280,280,280,280,280,280,280,280,280,280
280,280,280,280,280,280,280,280,280,280,280,280,280,361,280,280,280,280,280,280,280,280,280,280,280,280,280,280,280,280,280,280,280,280,280,280,280,406,280,280,280,280,280,280,280,280,280,280,280,280,280,280,280,280,280,280,280,280,360,280,280,280,280,280,280,280,280,280,280,280,280,280,280,280,280,407,280,280,280,280
280,280,280,280,280,280,280,280,280,280,280,407,280,406,280,280,280,280,280,280,280,280,280,280,280,280,280,280,280,280,280,280,280,280,280,280,407,280,280,280,280,362,280,280,280,280,280,280,280,280,280,280,280,280,280,280,280,280,362,280,280,280,280,280,280,280,280,280,280,280,280,280,280,280,280,405,280,280,280,280
280,280,280,280,280,280,280,280,280,280,406,406,280,361,280,280,280,280,280,280,280,280,280,280,280,280,360,280,280,280,280,280,280,280,280,362,280,280,280,280,280,405,280,280,280,280,280,280,280,280,280,280,280,280,280,280,280,407,280,280,280,280,280,280,280,280,280,280,280,280,280,280,280,280,280,280,280,280,280,280
280,280,280,280,280,280,280,280,280,280,280,280,280,362,280,280,280,280,280,280,361,280,280,280,280,280,280,280,280,280,280,280,280,280,280,280,280,280,280,280,280,280,280,280,280,280,280,280,280,280,280,280,280,280,280,280,280,405,280,280,280,280,280,280,280,280,280,280,280,280,280,280,280,280,280,280,280,280,280,280
280,280,280,280,280,280,280,280,280,280,280,280,280,280,360,280,280,280,280,280,280,280,280,280,280,280,280,280,280,280,280,280,280,280,280,280,280,280,280,280,280,280,280,280,280,280,407,362,280,280,280,280,280,280,280,280,405,280,280,280,280,280,280,280,280,280,280,280,280,280,280,280,280,280,280,280,280,280,280,280
280,280,280,280,280,280,280,280,280,280,280,280,280,280,407,280,280,280,280,280,280,280,280,280,280,280,280,280,280,280,280,280,280,280,280,280,280,280,280,280,280,280,280,280,280,280,280,362,280,280,280,280,280,280,280,406,280,280,280,280,280,280,280,280,280,280,280,280,280,280,280,280,280,280,280,280,280,280,280,280
227,280,226,227,280,280,280,280,280,280,280,280,407,407,280,280,280,280,280,280,280,280,280,280,280,280,280,280,280,280,280,280,280,280,406,280,280,280,280,280,362,280,280,280,280,280,280,361,280,280,280,280,280,280,280,280,280,280,280,280,406,280,280,280,280,280,280,280,280,280,280,280,280,280,280,280,280,280,280,280
285,226,271,272,280,280,280,280,280,407,360,407,280,280,280,280,280,280,280,280,280,280,280,280,280,280,280,280,280,280,280,280,280,280,360,280,280,280,280,280,362,280,280,280,280,280,360,280,280,280,280,280,280,280,280,280,280,280,280,361,362,280,280,280,280,280,280,280,280,280,280,280,280,280,280,280,280,280,280,280
271,271,271,272,280,280,280,361,360,280,280,405,280,280,280,280,280,280,280,280,280,362,280,280,280,280,280,280,280,280,280,280,280,280,362,280,280,280,280,280,405,280,280,280,280,280,405,362,361,406,280,280,280,280,280,280,280,280,280,406,280,280,280,280,280,280,280,280,280,280,280,280,280,280,280,280,280,280,280,280
271,271,240,317,280,280,280,280,280,280,280,280,280,280,280,280,280,280,280,280,280,280,280,280,280,280,407,280,280,280,280,280,280,280,360,280,280,280,280,280,280,280,280,280,280,280,406,280,280,280,280,280,280,280,280,280,280,280,360,280,280,280,280,280,280,280,280,280,280,280,280,280,280,280,280,280,280,280,280,280
271,271,272,280,280,280,280,280,280,280,280,280,280,280,280,280,280,280,280,280,280,280,280,280,280,280,280,280,280,280,406,280,280,360,280,280,280,362,280,280,280,280,280,280,280,280,280,280,280,280,280,280,280,280,280,280,280,280,280,280,280,280,280,280,280,280,280,280,280,280,225,226,226,226,227,280,280,280,280,280
271,240,317,280,280,280,280,280,280,280,280,280,280,280,280,280,280,280,280,280,280,280,280,280,280,280,280,280,280,280,280,280,280,362,280,280,280,280,280,280,280,280,407,280,280,280,280,280,280,280,280,280,280,280,280,280,280,280,280,280,280,280,280,280,280,280,280,280,280,280,270,271,271,271,285,226,227,280,225,226
240,317,280,280,280,280,280,280,280,280,280,280,280,280,280,362,280,280,280,361,280,280,280,280,280,280,280,280,280,280,280,280,280,406,280,280,280,280,280,280,280,280,280,280,280,280,280,280,280,280,280,280,280,280,280,280,280,280,280,280,280,280,280,280,280,280,280,280,225,226,286,271,271,271,271,271,285,226,286,271
317,280,280,280,280,280,280,280,280,280,280,280,280,280,406,360,280,280,280,361,360,280,280,280,280,280,280,280,280,280,280,280,407,280,280,280,280,280,280,280,280,280,280,280,280,280,280,280,280,280,280,280,280,280,280,280,280,280,280,280,280,280,280,360,361,280,225,226,286,271,271,271,271,271,271,271,271,271,271,271
280,280,360,280,280,280,280,280,280,280,280,280,361,362,362,280,280,362,406,280,280,280,280,280,280,280,280,280,280,280,280,280,362,280,280,280,280,280,280,280,280,280,280,280,280,280,280,280,280,280,280,280,280,280,280,280,280,280,280,280,280,406,361,361,280,225,286,271,271,271,240,316,316,316,316,316,316,316,316,316
280,280,280,280,280,280,280,280,280,280,406,406,405,280,280,280,405,405,280,280,280,280,280,280,280,280,280,280,280,280,280,406,280,280,280,280,280,280,280,280,280,280,280,280,280,280,280,280,280,280,280,280,280,280,280,280,280,280,280,280,280,361,280,225,226,286,271,271,240,316,317,280,280,280,280,280,280,225,226,226
280,280,280,280,280,280,280,280,280,280,280,280,280,280,280,280,280,280,280,280,280,280,280,280,280,280,280,280,280,280,280,280,280,280,280,280,280,280,280,280,280,280,280,280,280,280,280,280,280,360,280,280,280,280,280,280,280,280,280,280,280,280,225,286,271,271,271,240,317,280,280,280,280,280,225,226,226,286,271,271
280,280,280,280,280,280,360,280,280,405,361,280,280,280,280,280,280,280,280,280,280,280,280,280,280,280,280,280,280,280,280,280,280,280,280,280,280,280,280,280,280,280,280,280,280,280,280,280,360,280,280,280,280,280,280,280,280,280,280,280,280,225,286,271,271,240,316,317,280,280,280,280,225,226,286,271,271,271,271,240
280,280,280,280,280,280,280,280,280,280,280,280,280,280,280,280,280,280,280,280,280,280,280,280,280,280,280,280,280,280,280,280,280,280,280,280,280,280,280,280,280,280,280,280,280,280,280,280,280,280,280,280,280,362,280,280,280,280,280,225,226,286,271,271,240,317,280,280,280,225,226,226,286,271,271,271,240,316,316,317
280,280,280,280,280,280,280,280,280,280,407,280,280,280,280,280,280,280,280,280,280,280,280,280,280,280,280,280,280,280,280,280,280,280,280,361,280,280,280,280,280,280,280,280,280,280,280,280,280,280,280,280,280,280,280,280,280,280,225,286,271,271,240,316,317,280,225,226,226,286,271,271,271,240,316,316,317,280,280,280
280,280,280,280,280,280,280,280,280,280,280,280,280,280,280,280,405,407,280,280,280,280,280,280,280,280,280,280,280,280,280,280,280,280,280,280,280,280,280,280,280,280,280,280,280,280,280,280,280,280,280,280,280,280,280,280,280,225,286,271,271,240,317,280,280,225,286,271,271,271,240,316,316,317,280,280,280,280,280,280
280,280,280,280,280,280,280,280,280,280,280,280,280,280,280,280,360,280,280,280,280,280,280,280,280,280,280,280,280,280,280,280,280,280,280,280,280,280,280,280,280,280,280,280,280,280,280,280,280,280,280,280,280,280,280,225,226,286,271,271,240,317,225,226,226,286,271,271,271,271,272,280,280,280,280,280,280,280,280,280
280,280,280,280,280,280,280,280,280,280,280,280,280,280,280,280,280,280,280,280,280,280,280,280,280,280,280,280,280,280,280,280,280,280,280,280,280,280,280,280,280,280,280,280,280,280,280,280,280,280,280,280,280,225,226,286,271,271,271,271,285,226,286,271,271,271,271,240,316,316,317,280,280,280,280,280,280,280,280,280
280,280,280,280,280,280,280,280,280,280,280,280,280,280,280,280,280,280,280,280,280,280,280,280,280,280,280,280,280,280,280,280,280,280,280,280,280,280,280,280,405,406,407,360,280,280,280,280,280,280,280,280,225,286,271,271,271,271,271,271,271,271,271,240,316,316,316,317,280,280,280,280,280,280,280,280,280,280,280,225
280,280,280,280,280,280,280,280,280,280,280,280,280,280,280,280,280,280,280,280,280,362,362,280,280,280,280,280,280,280,280,280,280,280,280,280,280,280,280,406,280,280,280,280,280,280,280,280,280,280,225,226,286,271,271,271,271,271,271,271,240,316,316,317,280,280,280,280,280,280,280,280,280,280,280,280,280,225,226,286
280,280,280,280,280,280,280,280,280,280,280,280,280,280,280,280,280,280,280,280,280,280,280,280,280,280,280,280,280,280,280,280,280,280,280,280,280,280,280,362,280,280,406,280,280,280,280,280,280,225,286,271,271,271,271,271,271,271,240,316,317,280,280,280,280,280,280,280,280,280,280,280,280,280,280,225,226,286,271,271
280,280,280,280,280,280,280,280,280,280,280,280,280,280,280,280,280,280,280,280,280,280,280,280,280,280,280,280,280,280,280,280,280,280,280,280,280,280,280,280,280,280,280,280,280,280,280,225,226,286,271,271,271,271,271,240,316,316,317,280,280,280,280,280,280,280,280,280,280,280,280,280,225,226,226,286,271,271,271,271
280,280,280,280,280,280,280,280,280,280,280,280,280,280,280,280,280,280,280,280,280,280,280,280,280,280,280,280,280,280,280,280,280,280,280,280,280,280,280,280,280,280,280,280,280,280,225,286,271,271,271,240,316,316,316,317,280,280,280,280,280,280,280,280,280,280,280,280,225,226,226,226,286,271,271,271,271,271,271,271
280,280,280,280,280,280,280,280,280,280,280,280,280,280,280,280,280,280,280,280,280,280,280,280,280,406,362,280,280,280,280,280,280,280,280,280,280,280,280,280,280,280,280,280,225,226,286,271,271,240,316,317,280,280,280,280,280,280,280,280,280,280,280,280,280,225,226,226,286,271,271,271,271,271,271,271,271,271,271,271
280,280,280,280,280,280,280,280,280,280,280,280,280,280,280,280,280,280,280,280,280,280,280,280,280,280,280,280,407,407,280,280,280,280,280,280,280,280,280,280,280,280,225,226,286,271,271,240,316,317,280,280,280,280,280,280,280,280,280,280,280,280,225,226,226,286,271,271,271,271,271,271,271,271,271,271,271,271,271,271
