385,385,385,385,385,385,385,385,385,385,385,385,385,385,385,385,385,385,385,385,385,385,385,385,385,385,385,385,385,385,385,385,385,385,385,385,385,385,385,385,385,385,385,385,385,385,385,385,385,385,385,385,385,385,385,385,385,385,385,385,385,385,385,385,385,385,385,385,385,385,385,385,385,385,385,385,385,385,385,385
385,385,385,385,385,385,385,385,385,385,385,385,385,385,385,385,385,385,385,385,385,385,385,385,385,385,385,385,385,385,385,385,385,385,385,385,385,385,385,385,385,385,385,385,385,385,385,385,385,385,385,385,385,385,385,385,385,385,385,385,385,385,385,385,385,385,385,385,385,385,385,385,385,385,385,385,385,385,385,385
385,385,385,385,385,385,385,385,385,385,385,385,385,385,385,385,385,385,385,385,385,385,385,385,385,385,385,385,385,385,385,385,385,385,385,385,385,385,385,385,385,385,385,385,385,385,385,385,385,385,385,385,385,385,385,385,385,385,385,385,385,385,385,385,385,385,385,385,385,385,385,385,385,385,385,385,385,385,385,385
385,385,385,385,385,385,385,385,385,385,385,385,385,385,385,385,385,385,385,385,385,385,385,385,385,385,385,385,385,385,385,385,385,385,385,385,385,385,385,385,385,385,385,385,385,385,385,385,385,385,385,385,385,385,385,385,385,385,385,385,385,385,385,385,385,385,385,385,385,385,385,385,385,385,385,385,385,385,385,385
385,385,385,385,385,385,385,385,385,385,385,385,385,385,385,385,385,385,385,385,385,385,385,385,385,385,385,385,385,385,385,385,385,385,385,385,385,385,385,385,385,385,385,385,385,385,385,385,385,385,385,385,385,385,385,385,385,385,385,385,385,385,385,385,385,385,385,385,385,385,385,385,385,385,385,385,385,385,385,385
385,385,385,385,385,385,385,385,385,385,385,385,385,385,385,385,385,385,385,385,385,385,385,385,385,385,385,385,385,385,385,385,385,385,385,385,385,385,385,385,385,385,385,385,385,385,385,385,385,385,385,385,385,385,385,385,385,385,385,385,385,385,385,385,385,385,385,385,385,385,385,385,385,385,385,385,385,385,385,385
385,385,385,385,385,385,385,385,385,385,385,385,385,385,385,385,385,385,385,385,385,385,385,385,385,385,385,385,385,225,226,226,226,226,226,227,385,385,385,385,385,385,385,385,385,385,385,385,385,385,385,385,385,385,385,385,385,385,385,385,385,385,385,385,385,385,385,385,385,385,385,385,385,385,385,385,385,385,385,385
385,385,385,385,385,385,385,385,385,385,385,385,385,385,385,385,385,385,385,385,385,385,385,385,385,385,385,225,226,286,271,271,364,271,271,272,385,385,385,385,385,385,385,385,385,385,385,385,385,385,385,385,385,385,385,385,385,385,385,385,385,225,226,226,226,226,226,226,226,226,226,227,385,385,385,385,385,385,385,385
385,385,385,385,385,385,385,385,385,385,385,385,385,385,385,385,385,385,385,385,385,385,385,225,226,226,226,286,271,271,271,271,271,271,271,272,385,385,385,385,385,385,385,385,385,385,385,385,385,406,385,385,385,385,385,385,385,385,225,226,226,286,271,409,271,271,364,271,271,271,271,285,226,227,385,385,385,385,385,385
385,385,385,385,385,385,385,385,385,385,385,385,385,385,385,385,385,385,385,385,385,385,225,286,271,271,271,410,271,271,228,229,230,271,365,285,226,385,406,385,385,385,385,385,385,385,385,385,385,385,385,385,385,385,385,385,385,385,270,271,408,271,271,271,271,271,271,271,271,271,409,271,271,285,226,226,227,385,385,385
385,385,385,385,385,385,385,385,385,385,385,385,385,385,385,385,385,385,385,225,226,226,286,271,271,364,271,271,228,229,288,274,275,271,365,271,385,385,385,406,385,385,385,385,385,385,385,385,385,385,385,385,385,385,385,385,385,385,315,241,271,271,410,271,228,229,229,229,229,229,230,271,271,410,271,271,285,226,227,385
385,385,385,385,385,385,385,385,385,385,385,385,385,385,385,385,225,226,226,286,271,271,271,228,229,229,229,229,288,274,366,242,320,271,271,385,385,385,385,385,385,385,385,385,385,385,407,385,385,385,361,385,385,385,385,385,385,385,385,315,241,364,271,271,273,274,274,368,274,274,287,229,229,229,230,271,271,271,285,227
385,385,385,385,385,385,385,385,385,385,385,385,385,385,385,225,286,271,271,271,271,365,271,273,274,413,274,274,242,319,319,320,271,271,271,385,385,361,385,385,385,385,385,385,385,385,385,385,385,385,360,385,385,385,385,385,385,385,385,385,271,271,271,271,318,319,319,319,319,243,274,274,366,274,275,271,271,365,271,272
385,385,385,385,385,385,385,385,385,385,385,385,225,226,226,286,271,271,271,271,271,271,271,318,319,319,319,319,320,271,271,271,271,363,385,385,385,385,405,385,385,385,362,385,385,385,385,385,385,385,385,362,385,385,385,385,385,385,385,385,385,385,385,385,385,385,385,385,271,318,319,319,243,274,287,230,271,271,271,285
385,385,385,385,385,385,385,385,385,385,385,385,270,364,271,271,271,271,271,409,271,271,271,271,385,385,385,385,385,385,385,385,385,385,385,385,385,385,385,385,385,385,385,385,385,385,385,385,385,385,385,360,385,385,385,385,385,385,385,385,385,385,385,385,385,385,385,385,385,385,385,385,273,274,366,275,271,271,271,271
385,385,385,385,385,385,385,385,385,385,385,385,270,271,271,408,271,271,271,271,385,385,385,385,385,406,385,385,385,385,385,385,407,360,385,385,385,385,385,385,385,385,385,385,385,385,385,385,385,385,385,385,385,385,385,385,385,385,385,385,405,385,385,385,385,360,385,385,362,385,385,385,318,243,274,275,271,271,271,365
385,385,385,385,385,385,385,385,385,385,385,385,270,271,408,271,271,271,385,385,385,385,385,385,385,385,385,385,385,385,385,385,385,385,385,385,385,385,385,385,360,385,385,385,385,385,385,362,385,385,385,385,385,385,385,385,385,385,385,385,385,385,385,385,385,385,385,362,385,385,385,385,271,273,274,275,271,408,271,271
385,385,385,385,385,385,385,385,385,385,385,385,270,271,240,316,316,385,385,385,405,385,385,385,385,385,385,361,385,385,385,385,385,385,361,385,385,385,385,385,385,385,385,385,385,385,385,385,385,385,385,385,385,385,385,385,385,385,385,385,385,385,385,385,385,385,385,385,385,360,385,385,385,318,319,320,271,316,316,316
385,385,385,385,385,385,385,385,385,385,385,385,315,316,317,385,385,385,385,385,361,385,385,385,385,385,385,385,385,385,385,385,385,385,385,385,385,385,385,385,385,385,385,385,385,385,385,385,385,385,385,385,385,385,385,385,385,385,362,385,385,385,385,385,385,385,407,385,385,385,385,385,385,385,385,385,385,385,385,385
385,385,385,385,385,385,385,385,385,385,385,385,385,385,385,385,385,385,385,385,385,405,385,385,385,385,385,385,385,385,385,361,385,385,385,385,385,385,385,385,385,385,385,385,385,385,385,385,385,385,385,385,360,385,385,385,385,385,360,385,385,385,361,385,385,385,385,385,385,385,385,385,385,385,385,385,385,385,385,385
385,385,385,385,385,385,385,385,385,385,385,385,385,385,385,385,385,385,385,385,385,385,360,385,385,385,385,385,385,385,385,407,385,360,385,385,385,385,385,385,385,362,385,385,385,385,385,385,385,385,385,385,385,385,385,385,385,385,385,385,385,385,385,385,385,385,385,385,385,385,385,385,385,385,385,385,385,385,385,361
385,385,385,385,385,385,385,385,385,385,385,385,385,385,385,385,385,385,385,385,385,385,385,385,385,385,360,385,385,385,385,385,385,385,385,385,385,385,385,385,385,385,385,385,385,225,226,226,226,227,385,385,385,385,385,385,385,385,385,385,385,385,385,360,385,385,385,385,385,407,385,385,385,385,385,385,385,385,385,385
385,385,385,385,385,385,385,385,385,385,385,385,385,385,225,226,227,385,406,385,385,385,385,385,385,385,385,385,385,385,385,385,385,385,385,385,385,385,385,361,385,385,225,226,226,286,271,271,271,285,226,226,226,226,227,385,385,385,385,385,385,385,385,385,385,385,385,385,385,385,385,385,385,385,385,385,407,385,385,385
385,385,385,385,385,385,385,385,385,385,385,385,385,225,286,271,272,385,362,361,385,385,385,385,385,385,385,406,405,385,385,385,385,385,385,385,385,385,385,385,385,385,270,271,271,271,409,271,271,271,271,271,271,271,285,226,227,385,385,385,385,385,385,385,385,385,385,385,385,385,385,385,385,385,407,385,385,405,385,385
385,385,385,385,385,385,385,385,385,385,385,225,226,286,271,271,272,385,385,360,385,385,361,385,385,385,385,360,385,385,385,385,385,385,385,385,385,406,385,385,225,226,286,271,271,271,271,271,271,271,408,240,241,271,271,271,285,227,385,385,385,385,385,360,385,385,385,385,361,385,385,385,385,385,385,385,385,385,385,385
385,385,385,385,385,385,385,385,385,225,226,286,271,271,271,271,272,385,385,385,405,385,385,385,385,385,385,385,385,385,385,385,385,361,405,385,385,225,226,226,286,271,271,271,271,271,408,271,271,271,271,272,315,316,241,271,271,285,227,385,385,385,385,385,385,385,385,385,385,385,385,385,385,385,385,406,385,385,385,385
385,385,385,385,385,385,225,226,227,270,271,271,271,271,365,271,285,227,385,385,385,385,385,385,385,385,385,385,385,385,385,385,385,385,385,385,385,270,271,271,271,271,271,363,271,271,271,271,271,271,271,285,227,385,315,241,271,271,285,227,385,385,385,385,385,385,385,385,385,385,385,385,385,385,385,406,385,361,385,385
385,385,385,385,385,385,270,271,285,286,271,271,271,271,240,241,271,272,385,385,385,385,361,385,385,385,385,385,385,385,385,385,225,226,226,226,226,286,271,271,271,271,271,228,229,229,229,229,229,230,271,271,285,227,385,315,241,271,271,285,226,227,385,385,405,385,385,385,385,385,385,385,385,385,385,385,385,385,385,385
385,385,385,225,226,226,286,271,271,271,271,271,271,271,272,270,271,272,385,385,385,385,385,385,385,385,405,385,385,385,385,385,270,271,271,271,271,271,271,408,271,271,228,288,274,274,274,274,274,275,271,271,271,285,226,226,286,271,409,271,271,272,385,385,385,385,385,385,385,385,385,385,385,385,385,385,385,385,385,385
385,385,225,286,271,271,271,271,271,271,363,365,271,271,272,270,271,272,385,385,385,385,385,385,385,385,385,385,385,225,226,226,286,271,271,271,271,271,271,271,271,228,288,274,367,411,274,274,274,287,230,271,271,271,271,365,271,271,271,271,271,285,226,227,225,226,227,385,385,385,385,385,385,385,385,360,385,360,385,385
385,225,286,271,271,271,271,408,271,271,271,271,271,240,317,270,271,272,385,385,385,385,385,360,360,385,385,385,225,286,271,271,271,271,271,364,271,271,271,271,228,288,274,274,274,274,274,274,274,274,275,271,364,271,271,271,271,271,365,410,271,271,271,285,286,271,285,226,226,226,226,227,385,385,385,385,385,385,385,385
385,270,271,271,365,271,271,271,271,271,271,271,271,272,225,286,271,272,385,385,385,385,385,407,385,385,385,385,270,271,271,271,271,365,271,271,271,271,228,229,288,274,274,368,274,242,319,319,243,274,275,228,229,229,229,229,230,271,271,271,271,271,271,271,271,271,271,271,271,365,271,285,226,227,385,385,385,385,385,385
225,286,271,271,271,271,271,271,364,271,271,271,271,285,286,408,271,272,385,385,385,385,385,385,385,385,225,226,286,271,363,271,271,271,271,271,228,229,288,274,274,413,274,274,274,287,229,229,288,274,287,288,274,274,274,274,287,229,230,271,271,271,271,271,409,271,271,271,271,271,271,271,271,285,226,227,385,385,385,385
270,271,364,364,410,271,271,271,271,271,365,271,271,408,271,271,240,317,385,385,407,385,385,385,385,225,286,271,271,271,271,271,271,271,271,228,288,274,274,274,274,274,274,274,274,274,274,274,274,274,274,274,413,411,274,274,274,274,287,229,230,271,364,271,271,271,364,271,271,240,316,241,271,271,363,285,226,227,385,385
270,271,271,271,271,408,271,271,271,271,271,365,271,271,271,240,317,385,385,406,385,385,385,225,226,286,271,271,271,271,271,228,229,229,229,288,274,274,274,274,274,274,413,274,274,274,411,274,274,274,274,411,274,274,274,274,366,274,274,274,287,230,271,271,271,271,409,271,271,285,227,315,316,241,271,271,271,272,385,385
286,271,271,363,271,271,271,271,410,271,271,271,271,271,240,317,385,385,385,385,405,385,385,270,271,271,271,271,271,271,271,273,274,367,274,274,274,274,274,274,274,274,274,274,274,413,412,274,274,274,274,367,274,274,274,274,274,274,274,274,274,287,229,230,271,271,271,271,271,271,285,226,226,286,271,271,271,285,227,385
271,271,271,271,271,409,271,271,271,271,271,240,316,316,317,385,385,385,385,385,385,385,225,286,364,271,271,409,271,271,271,273,274,242,319,319,319,319,319,319,319,319,243,274,274,274,274,274,274,367,274,274,274,412,412,274,274,274,274,274,274,411,274,287,229,229,229,229,230,271,271,271,271,271,271,271,271,271,285,226
271,408,271,271,271,271,271,271,271,240,316,317,385,385,385,385,385,385,385,385,385,385,270,271,271,271,271,271,271,271,271,318,319,320,271,271,271,271,271,271,271,271,318,319,243,274,274,274,274,274,274,274,274,274,274,274,412,274,274,274,274,274,274,274,274,274,274,274,287,229,229,230,271,271,271,271,410,271,271,271
271,271,271,271,271,271,271,271,240,317,385,385,385,385,385,385,385,385,385,385,385,385,270,271,271,271,271,271,271,271,271,271,271,271,271,409,271,271,271,363,271,271,271,271,318,319,319,319,319,243,274,274,274,274,274,274,412,274,274,274,274,274,274,274,274,274,274,274,274,274,274,287,229,230,271,271,271,271,364,271
271,364,271,271,271,271,240,316,317,385,385,385,385,385,385,385,406,385,385,385,385,385,315,241,271,365,271,271,271,271,271,409,271,271,271,271,271,271,271,271,271,271,271,271,271,271,271,271,271,318,319,243,274,274,274,274,274,274,274,274,274,274,274,366,274,274,274,274,274,274,274,274,274,287,229,230,271,271,271,271
271,271,271,271,240,316,317,385,385,385,385,405,385,385,385,385,385,385,385,362,385,385,385,270,271,271,271,271,271,271,271,271,271,271,271,271,271,271,271,271,271,410,271,271,271,271,271,271,271,271,271,318,319,243,274,274,274,274,274,274,274,274,274,274,274,274,274,274,274,274,274,274,274,274,274,287,229,229,229,229
316,316,316,316,317,385,385,385,385,385,385,385,385,385,385,385,385,385,385,385,385,385,385,315,316,316,316,316,316,316,241,271,271,240,316,316,316,316,316,316,241,271,271,271,408,271,271,271,271,271,271,271,271,318,319,319,319,319,319,319,319,243,274,274,274,274,274,366,274,274,367,274,274,368,274,274,274,274,274,274
385,385,385,385,385,385,385,385,385,385,385,385,385,385,385,385,385,385,385,385,385,385,385,385,385,385,385,385,385,385,315,316,316,317,385,385,385,385,385,385,315,316,241,271,271,271,271,271,409,271,271,271,271,271,271,271,271,271,271,271,271,318,319,319,243,274,274,274,274,274,412,274,274,274,274,274,274,274,274,274
385,385,385,385,385,385,385,385,385,385,385,385,385,385,385,385,385,385,385,385,405,385,385,385,385,385,385,385,385,385,385,385,385,385,385,385,385,385,385,385,385,385,315,316,316,316,316,316,241,271,271,271,363,271,364,271,271,271,271,271,271,271,271,271,273,274,368,274,274,274,411,274,274,274,274,274,274,274,274,274
385,385,405,385,385,385,385,385,385,385,385,385,385,385,385,385,385,361,385,385,385,385,385,385,385,385,385,405,385,385,385,385,385,385,385,385,385,385,385,385,385,406,385,385,385,385,385,385,315,316,316,241,271,271,271,271,271,271,410,271,271,365,271,271,273,274,274,274,274,274,367,368,274,274,274,366,274,411,274,274
385,385,360,385,385,385,385,385,385,385,385,385,385,385,407,385,385,385,385,385,385,385,385,385,385,385,385,385,385,385,385,385,385,407,385,385,385,385,385,385,407,385,385,385,385,385,385,385,385,385,385,315,316,241,271,271,271,271,271,271,271,271,271,271,318,243,274,274,274,274,274,412,274,274,274,274,274,274,274,274
385,385,385,385,385,385,385,385,385,385,385,385,385,385,385,385,385,405,385,385,385,385,385,406,385,385,385,385,385,406,385,385,385,360,385,385,385,385,385,385,385,385,385,385,385,385,385,385,385,385,385,385,385,270,271,271,271,409,271,271,271,363,271,271,271,318,319,319,243,274,274,274,274,274,274,274,274,274,274,274
385,385,385,385,385,361,385,385,385,385,385,385,385,385,385,385,361,405,385,385,385,385,385,385,385,385,385,385,385,385,385,385,385,385,385,385,385,385,385,385,405,385,385,385,385,385,385,385,385,362,362,385,385,315,316,241,271,271,271,271,271,271,271,271,271,271,271,271,318,243,274,274,274,274,274,412,274,368,274,274
385,385,385,385,385,385,362,385,385,385,385,385,385,385,385,385,385,385,385,385,385,405,385,385,385,385,385,385,385,385,405,385,385,385,385,385,385,385,385,360,385,385,385,385,360,385,385,385,361,385,361,385,385,385,385,315,241,271,271,271,271,271,363,271,271,408,271,271,271,273,274,274,366,274,274,368,274,274,274,274
385,385,385,385,385,385,385,385,385,362,407,385,385,385,385,385,385,385,385,385,385,385,385,385,385,385,385,385,385,361,385,385,385,360,385,385,385,385,385,360,385,385,385,385,385,385,385,385,385,385,385,385,407,385,385,385,315,316,316,316,316,241,271,271,271,271,271,364,271,318,243,274,274,274,274,274,274,274,368,274
385,385,385,385,385,385,385,385,385,361,385,385,385,385,385,385,385,385,360,385,385,385,385,385,385,385,385,385,385,385,385,385,385,385,385,385,385,385,385,385,385,385,385,385,406,385,407,362,385,385,385,385,385,362,385,385,407,385,385,385,385,315,241,271,271,271,271,271,271,271,273,274,274,274,413,413,274,274,274,274
385,385,385,385,385,385,385,385,385,407,385,385,385,385,385,385,385,385,385,385,385,385,225,226,226,226,226,226,226,226,227,385,385,385,385,385,385,225,226,226,227,385,385,385,385,385,385,385,385,385,385,407,385,385,385,385,385,385,385,385,385,385,315,241,408,271,409,271,364,271,273,274,274,274,274,274,274,274,274,274
385,385,385,385,361,385,385,385,385,385,385,385,385,385,385,385,385,385,225,226,226,226,286,271,271,271,271,271,271,271,285,226,226,227,385,225,226,286,271,271,285,226,226,227,385,385,385,385,385,385,406,385,385,385,385,385,385,385,385,385,406,385,385,270,271,271,271,271,271,271,273,274,274,274,274,274,274,274,274,242
385,385,406,385,360,385,385,385,385,385,385,385,225,226,226,226,226,226,286,271,271,271,271,271,271,271,408,271,410,271,271,271,271,285,226,286,271,271,271,271,271,271,271,285,227,385,385,385,385,385,385,385,385,385,385,385,361,385,385,385,385,385,385,315,241,271,271,271,271,271,318,243,274,274,274,274,413,274,367,287
385,385,407,385,385,385,385,385,385,385,385,225,286,271,271,271,271,271,271,271,271,271,363,271,271,271,271,271,271,271,271,271,364,271,271,271,271,365,271,240,316,241,408,271,285,226,227,385,385,385,385,405,385,385,385,385,385,385,385,385,385,385,385,385,315,316,241,271,271,271,271,273,274,274,368,274,274,274,413,274
385,385,385,385,385,385,385,385,385,225,226,286,271,271,271,271,271,271,271,409,271,271,271,228,229,229,229,229,230,271,271,271,271,271,271,271,271,271,271,285,227,315,241,271,271,410,285,226,227,385,385,385,385,362,385,385,385,385,385,385,385,362,385,385,385,385,270,271,409,271,271,318,243,274,274,274,274,274,274,274
385,385,385,385,385,385,385,225,226,286,271,271,271,271,410,271,364,271,271,271,228,229,229,288,274,274,274,274,287,229,229,230,228,229,230,271,271,271,271,271,285,227,315,316,241,271,271,271,285,226,227,385,385,385,385,385,385,385,360,385,385,361,385,385,385,385,270,271,271,271,271,271,318,243,274,274,368,274,274,274
385,385,385,385,385,385,225,286,271,271,240,316,241,271,271,271,271,271,271,228,288,274,274,274,274,413,274,242,243,274,274,287,288,274,287,229,230,271,271,271,363,285,226,227,315,316,241,271,409,271,285,226,227,385,385,385,385,385,385,385,385,385,361,361,385,385,270,364,271,271,271,271,271,273,274,274,274,274,368,274
407,385,385,385,385,385,270,271,271,240,317,225,286,271,271,271,271,271,228,288,274,274,274,274,274,274,274,287,288,274,274,274,274,274,274,274,275,271,410,271,271,271,271,285,226,227,315,316,241,271,271,271,285,226,227,385,385,385,385,385,385,385,385,385,385,385,315,241,271,271,271,271,271,318,243,274,274,411,367,242
406,385,385,385,385,385,270,271,240,317,225,286,271,408,271,271,271,228,288,411,412,274,274,274,368,274,274,274,274,274,274,274,274,274,274,274,287,230,271,271,271,271,271,271,271,285,227,385,315,316,316,241,271,271,272,385,385,385,385,385,385,407,385,385,385,385,385,270,271,271,271,410,271,271,273,274,274,367,274,287
362,405,385,385,385,225,286,271,272,225,286,271,271,271,271,271,228,288,274,274,274,274,274,274,274,274,274,274,368,274,274,274,274,367,274,274,274,287,229,230,271,271,271,365,271,271,285,226,227,225,227,315,241,271,285,227,385,385,385,385,385,406,385,360,385,385,385,270,271,271,271,271,271,271,273,274,274,274,274,274
385,385,385,385,385,270,271,271,285,286,271,271,271,271,271,228,288,274,274,274,274,274,274,274,274,274,274,274,274,274,274,274,274,274,274,274,274,368,274,287,230,271,271,271,271,271,271,271,285,286,285,227,270,271,271,285,227,385,385,361,385,385,385,385,385,385,225,286,271,271,271,271,271,410,273,274,368,274,274,274
385,385,385,385,225,286,409,271,271,271,271,271,364,271,271,273,274,274,274,274,274,413,368,274,274,274,274,274,274,274,274,274,274,274,274,274,274,366,366,274,287,230,271,271,408,271,271,271,271,271,271,285,286,271,271,271,285,227,385,385,385,385,385,385,385,385,270,271,271,409,271,410,271,271,273,274,274,274,412,274
385,385,385,385,270,271,271,271,364,271,271,271,271,271,228,288,274,274,274,274,274,274,274,274,274,274,274,274,274,412,274,274,274,274,274,274,274,274,274,411,274,287,230,271,271,271,271,271,271,271,271,271,271,271,271,271,271,272,385,385,360,385,385,385,385,385,270,271,271,271,271,271,271,228,288,274,274,274,274,274
385,385,385,385,270,271,271,271,271,271,271,271,271,228,288,274,274,274,412,274,274,274,274,274,413,274,274,274,274,274,274,274,274,274,411,413,274,274,274,274,274,274,275,271,271,271,271,271,271,363,271,271,271,364,271,271,271,285,226,227,385,385,385,385,385,385,270,271,271,271,271,271,271,273,274,274,274,274,274,274
385,385,385,385,270,271,271,271,271,410,271,271,228,288,274,274,413,274,274,274,274,274,274,274,274,274,367,274,274,274,274,274,274,274,274,274,274,274,274,274,274,274,287,229,230,271,271,364,271,271,271,271,271,271,271,271,364,271,271,272,385,225,226,227,385,225,286,271,271,363,271,271,228,288,274,274,368,411,274,274
385,385,385,385,315,241,364,271,271,271,271,271,273,274,367,274,274,274,274,274,274,274,274,274,274,274,274,274,411,274,274,274,274,274,274,367,274,274,274,274,413,274,274,274,287,230,271,271,271,271,271,271,271,271,271,271,271,271,271,285,226,286,271,285,226,286,271,271,271,271,271,228,288,274,367,274,274,274,274,367
385,385,385,385,225,286,271,271,271,271,271,228,288,274,274,274,274,274,274,274,274,274,274,274,274,274,274,274,411,274,274,274,274,274,274,412,274,274,274,274,274,274,274,274,274,287,229,229,230,271,271,271,271,271,271,271,271,271,271,271,271,271,408,271,271,271,271,365,271,271,228,288,274,274,411,274,274,274,274,274
385,385,385,225,286,271,271,364,271,271,228,288,274,274,412,274,274,274,274,274,274,274,274,274,274,274,274,274,274,274,274,274,274,274,274,274,274,274,274,274,274,274,274,274,411,274,274,274,287,229,229,230,271,271,271,365,271,271,271,271,271,363,271,271,271,271,271,271,271,271,273,274,274,274,411,274,274,274,274,274
385,385,225,286,271,271,271,271,271,271,273,274,274,274,274,274,274,274,274,274,274,274,274,274,274,274,274,274,274,274,274,274,274,274,274,274,274,274,274,274,274,274,274,274,274,274,274,274,412,274,274,287,229,229,229,230,271,271,271,271,271,271,271,271,271,228,229,229,229,229,288,274,274,274,274,274,274,411,274,274
225,226,286,271,271,363,271,271,271,228,288,274,274,274,274,274,274,274,274,274,274,274,274,274,274,274,274,274,274,274,274,274,274,274,274,274,274,274,274,274,274,274,274,274,274,274,274,274,274,274,274,274,274,274,274,287,229,229,229,229,229,229,229,229,229,288,274,274,274,274,274,274,274,413,274,274,274,274,274,274
286,271,271,271,271,271,271,228,229,288,274,274,274,274,274,274,274,274,274,274,274,274,274,274,274,274,274,274,274,274,274,274,274,274,274,274,274,274,274,274,274,274,274,367,274,274,274,274,366,274,274,274,274,413,274,274,274,274,274,274,274,274,274,274,274,274,274,274,274,274,274,274,274,274,274,274,274,274,274,274
271,365,271,271,271,271,228,288,274,274,274,274,274,274,274,274,274,274,274,274,274,274,274,274,274,274,274,274,274,274,274,274,274,274,274,274,274,274,274,274,274,274,274,274,274,274,274,274,274,274,274,368,274,274,274,274,274,274,274,274,274,412,274,274,274,274,368,274,413,274,274,274,274,274,367,274,274,274,274,274
271,271,271,408,271,228,288,274,274,274,274,274,274,274,274,274,274,274,274,274,274,274,274,274,274,274,274,274,274,274,274,274,274,274,274,274,274,274,274,274,274,274,274,274,274,274,274,274,274,274,274,274,274,274,274,274,274,274,274,274,274,274,412,274,274,274,274,274,274,274,274,274,366,274,368,274,274,274,274,274
409,271,271,271,271,273,274,274,274,274,274,274,274,274,274,274,274,274,274,274,274,274,274,274,274,274,274,274,274,274,274,274,274,274,274,274,274,274,274,274,274,274,274,274,274,274,274,274,274,274,274,274,368,274,274,274,366,274,274,274,368,413,274,274,274,274,274,274,274,274,274,368,368,274,274,274,274,274,274,274
271,271,271,228,229,288,274,274,274,274,274,274,274,274,274,274,274,274,274,274,274,274,274,274,274,274,274,274,274,274,274,274,274,274,274,274,274,274,274,274,274,274,274,274,274,274,274,274,274,274,274,274,274,274,274,274,274,274,274,274,366,274,274,274,368,274,274,274,274,274,274,274,274,274,274,274,274,274,274,274
271,271,228,288,274,274,274,274,274,274,274,274,274,274,274,274,274,274,274,274,274,274,274,274,274,274,274,274,274,274,274,274,274,274,274,274,274,274,274,274,274,274,274,274,274,274,274,274,274,274,274,274,274,274,274,274,274,274,274,274,274,274,274,274,274,274,412,274,274,274,274,274,274,274,274,274,274,274,412,274
271,228,288,274,413,368,274,274,274,274,274,274,274,274,274,274,274,274,274,274,274,274,274,274,274,274,274,274,274,274,274,274,274,274,274,274,274,274,274,274,274,274,274,274,274,274,274,274,274,274,274,274,274,274,274,274,274,274,274,274,274,274,274,274,274,412,367,274,274,274,274,274,366,274,274,274,411,274,274,274
228,288,412,274,412,274,274,274,274,274,274,274,274,274,274,274,274,274,274,274,274,274,274,274,274,274,274,274,274,274,274,274,274,274,274,274,274,274,274,274,274,274,274,274,274,274,274,274,274,274,274,274,274,274,274,274,274,274,274,274,274,274,274,274,274,274,274,274,274,413,274,274,274,274,274,274,274,274,274,274
273,274,411,274,274,274,274,274,274,274,274,274,274,274,274,274,274,274,274,274,274,274,274,274,274,274,274,274,274,274,274,274,274,274,274,274,274,274,274,274,274,274,274,274,274,274,274,274,274,274,274,274,274,274,274,274,274,274,274,274,274,274,274,274,274,274,274,274,274,274,274,274,274,274,274,274,274,274,274,274
