280,280,280,280,280,280,280,280,280,280,280,280,280,280,280,280,280,280,280,280,280,280,280,280,280,280,280,280,280,280,280,280,280,280,280,280,280,280,280,280,280,280,280,280,280,280,280,280,280,280,280,280,280,280,280,280,280,280,280,280,280,280,280,280,280,280,280,280,280,280,280,280,280,280,280,280,280,280,280,280
280,280,280,280,280,280,280,280,280,280,280,280,280,280,280,280,280,280,280,405,280,280,405,280,280,280,280,280,280,280,280,280,280,280,280,280,280,280,280,280,280,280,280,280,280,280,280,280,280,280,280,280,280,280,280,280,280,280,280,280,280,280,280,280,280,280,280,280,280,280,280,280,280,280,280,280,280,280,280,280
280,280,280,280,280,280,280,280,280,280,280,280,280,280,280,280,280,280,280,280,280,280,362,280,280,280,280,280,280,280,280,280,280,280,280,280,280,280,280,280,280,280,280,280,280,280,280,280,280,280,280,280,280,280,280,280,280,280,280,280,280,280,280,280,280,280,280,280,280,280,280,280,280,280,280,280,280,280,280,280
280,280,280,280,280,280,280,280,280,280,280,280,280,280,280,280,280,280,280,407,361,361,360,361,361,361,407,361,361,280,280,280,280,280,280,280,280,280,280,280,280,280,280,280,280,280,280,280,280,280,280,280,280,280,280,280,280,280,280,280,280,280,280,280,280,280,280,280,280,280,280,280,280,280,280,280,280,280,280,280
280,280,280,280,280,280,280,280,362,280,280,280,280,280,280,280,361,407,407,280,280,362,280,280,280,280,280,280,280,280,280,280,280,280,280,280,280,280,280,280,280,280,280,280,280,280,280,280,280,280,280,280,280,280,280,280,280,280,280,280,280,280,280,280,280,280,280,280,280,280,280,280,280,280,280,280,280,360,280,280
280,280,280,280,280,280,280,361,406,280,280,280,280,280,280,280,280,280,280,280,280,361,280,280,280,280,280,280,280,280,280,280,280,280,280,280,280,280,280,280,280,280,280,280,280,280,280,280,280,280,280,280,280,280,280,280,280,280,280,280,280,280,280,280,280,280,280,280,280,280,280,280,280,280,280,280,280,405,280,280
280,280,280,280,280,280,280,362,407,280,280,280,280,280,280,280,280,280,280,280,362,280,280,280,280,280,280,280,280,280,280,280,280,280,280,280,280,280,280,280,280,280,280,280,280,280,280,280,280,280,280,280,280,280,280,280,280,280,280,280,280,280,280,280,280,280,280,280,280,280,280,280,280,280,280,280,280,280,280,280
280,280,280,280,280,280,280,407,361,280,280,280,280,280,280,280,280,280,280,407,280,280,280,280,280,280,280,280,280,280,280,280,280,280,280,280,280,280,280,280,280,280,280,280,280,280,280,280,280,280,280,280,280,280,280,280,280,280,280,280,280,280,280,280,280,280,280,280,280,280,280,280,280,280,280,280,280,280,280,280
280,280,280,280,280,280,280,362,407,280,280,280,280,280,280,280,280,280,362,280,280,280,280,280,280,280,280,280,360,280,280,280,280,280,280,280,407,280,280,280,280,280,280,280,280,280,280,280,280,280,280,280,280,280,280,280,280,280,280,280,280,280,280,280,280,280,280,280,280,280,280,280,280,280,280,280,280,280,280,280
280,280,280,280,280,280,280,406,280,280,280,280,280,280,280,280,280,280,280,280,280,280,280,280,280,280,280,407,280,280,280,280,280,280,280,280,407,280,280,280,280,280,280,280,280,280,280,280,280,280,280,280,280,280,280,280,280,280,280,280,280,280,280,280,280,280,280,280,280,280,280,280,280,280,280,280,280,280,280,280
280,280,280,280,280,280,280,362,280,280,280,280,280,280,280,280,280,280,280,280,280,280,280,280,280,360,362,280,280,280,280,280,280,280,280,361,280,280,280,280,280,280,280,280,280,280,280,280,280,280,280,280,280,280,280,280,280,280,280,280,280,280,280,280,280,280,280,280,280,280,280,280,280,280,280,280,280,280,280,280
280,280,280,280,280,280,280,280,280,280,280,280,280,280,280,280,280,280,280,280,280,280,280,280,360,280,280,280,280,280,280,280,280,280,405,280,280,280,280,280,280,280,280,280,280,280,280,280,280,280,280,280,280,280,280,280,280,280,280,280,280,280,280,361,407,405,360,405,280,280,360,280,280,362,405,407,361,361,362,362
280,280,280,405,280,280,280,280,280,280,405,362,362,405,406,280,280,280,280,280,280,280,280,280,280,280,280,280,280,280,280,280,405,362,280,280,280,280,280,280,280,280,280,280,280,280,280,280,280,280,280,280,280,280,280,280,280,280,280,280,280,280,280,280,280,280,280,280,280,280,280,280,280,280,280,280,280,280,280,280
280,407,362,280,280,280,280,280,280,280,280,280,280,280,280,280,280,280,280,280,280,280,280,280,280,280,280,280,280,280,280,280,280,280,280,280,280,280,280,280,280,280,280,280,280,280,280,280,280,280,280,280,280,280,280,280,280,280,360,280,280,280,280,280,280,280,280,280,280,280,280,280,280,280,280,280,280,280,280,280
362,280,280,280,407,280,280,280,280,280,280,280,280,280,280,280,280,280,280,280,280,280,280,280,280,280,280,280,280,280,280,280,280,280,280,280,280,280,280,280,280,280,280,280,280,280,280,280,280,280,280,280,280,280,280,280,362,406,280,280,280,280,280,280,280,280,361,405,280,280,280,280,280,280,361,280,280,280,280,280
280,280,280,280,280,280,280,280,280,280,280,280,280,280,280,280,280,280,280,280,280,280,280,280,280,280,280,280,280,280,280,280,280,280,280,280,280,280,280,280,280,280,280,280,280,280,361,361,407,407,406,280,280,280,406,280,280,280,280,280,280,280,280,280,280,280,280,361,280,280,280,280,280,280,280,280,280,280,280,280
280,280,280,280,280,280,280,280,280,280,280,280,280,280,280,280,280,280,280,280,280,280,280,280,280,280,280,280,280,280,280,280,280,361,406,360,362,362,361,360,362,280,280,361,360,405,280,280,280,280,280,280,280,280,280,280,280,280,280,280,280,280,280,280,280,280,280,407,280,280,280,280,280,360,280,280,407,361,280,280
280,280,280,280,280,280,280,280,280,280,280,280,280,280,280,280,280,280,280,280,280,280,280,280,280,280,280,280,280,280,280,280,280,280,280,280,280,280,280,280,280,280,280,280,280,280,280,280,280,280,280,280,280,280,280,280,280,280,280,280,280,280,280,406,280,280,280,280,280,280,280,280,280,280,362,407,405,280,280,280
280,280,280,280,280,280,280,280,280,280,280,280,280,280,280,280,280,280,280,280,280,280,280,280,280,280,280,280,280,280,280,280,280,280,280,280,280,280,280,280,280,280,280,280,280,280,280,280,280,280,280,280,280,280,280,280,280,280,280,280,280,280,280,280,280,280,280,280,362,362,407,362,280,280,406,360,280,280,280,280
280,280,280,280,280,280,280,280,280,280,280,280,280,280,280,280,280,280,280,280,280,280,280,280,280,280,280,280,280,280,280,280,280,280,280,280,280,280,406,280,280,280,280,280,280,280,280,280,280,280,280,280,280,280,280,280,407,280,405,280,280,280,280,280,280,361,360,280,280,280,407,280,360,407,280,280,280,280,280,280
280,280,280,280,280,280,280,280,280,280,280,280,280,280,280,280,280,280,280,280,405,362,360,360,407,362,361,280,280,280,280,280,280,280,280,280,280,280,361,280,280,280,280,280,280,280,280,280,280,280,280,280,280,280,280,280,280,280,360,280,280,280,280,280,280,280,280,280,407,280,280,360,280,280,280,280,280,225,226,226
280,280,280,280,280,280,280,280,280,280,280,280,280,280,280,280,280,280,280,280,280,280,280,280,280,280,280,280,280,280,280,280,280,280,280,280,280,280,362,280,280,280,280,280,280,280,280,280,280,280,280,280,280,280,280,407,280,280,280,280,280,280,280,280,280,280,407,407,280,280,280,280,280,280,280,225,226,286,271,271
280,280,280,280,280,280,280,280,280,280,280,280,280,280,280,280,280,280,280,280,280,280,280,280,280,280,280,280,280,280,280,280,280,280,280,280,280,280,362,280,280,280,280,280,361,280,280,280,280,280,280,280,280,280,280,280,280,280,280,280,280,280,280,280,280,406,280,360,280,280,280,280,280,280,225,286,271,240,316,316
280,280,280,280,280,280,280,280,280,280,280,280,280,280,280,280,280,280,280,280,280,280,280,280,280,280,280,280,280,280,280,280,280,280,280,280,406,362,280,280,280,280,280,361,280,280,280,280,280,406,280,280,406,280,280,280,280,280,280,280,280,280,280,406,406,362,361,280,280,280,280,280,225,226,286,271,271,285,226,226
280,280,280,280,280,280,280,280,280,280,280,280,280,280,280,280,280,280,280,280,280,280,280,280,280,280,280,280,280,280,280,280,280,280,362,360,362,280,280,280,280,280,225,226,226,227,280,280,280,280,280,280,280,280,280,280,280,280,280,280,280,362,361,361,280,280,280,280,280,280,280,225,286,271,271,271,271,271,271,271
280,280,280,280,280,280,280,280,280,280,280,280,280,280,280,280,280,280,280,280,280,280,280,280,280,280,280,280,280,280,280,280,280,280,280,280,406,280,280,225,226,226,286,271,271,272,280,280,280,280,280,280,280,280,280,280,280,280,407,360,360,362,280,280,280,280,280,280,280,225,226,286,271,363,364,271,271,271,271,271
280,280,280,280,280,280,280,280,280,280,280,280,280,280,280,280,280,280,280,280,280,280,280,280,280,280,280,280,280,280,280,280,280,280,361,360,280,280,225,286,271,271,410,365,240,317,280,280,362,280,280,280,280,280,280,280,362,407,407,280,280,280,280,280,280,280,280,225,226,286,271,271,271,410,271,271,271,271,271,271
280,280,280,280,280,280,280,280,280,280,280,280,280,280,280,280,280,280,280,280,280,280,280,280,280,280,280,280,280,280,280,280,280,280,407,280,280,225,286,271,271,240,316,316,317,280,280,280,280,280,280,280,280,280,280,360,280,280,280,280,280,280,280,280,280,225,226,286,271,271,271,271,271,271,271,271,271,271,271,271
280,280,280,280,280,280,280,280,280,280,280,280,280,280,280,280,280,280,280,361,280,280,280,280,280,280,280,280,280,280,280,280,280,280,280,225,226,286,271,271,240,317,280,280,280,280,280,280,280,280,280,280,280,360,360,406,280,280,280,280,280,280,280,280,225,286,271,271,271,271,410,271,271,271,271,271,271,271,271,271
280,280,280,280,280,280,280,280,280,280,280,280,280,280,280,280,280,280,405,280,280,280,280,280,280,280,280,280,280,280,280,360,280,280,225,286,271,271,409,240,317,280,280,280,280,280,280,280,280,280,280,405,360,405,280,280,280,280,280,280,280,280,280,225,286,271,271,271,271,271,271,271,271,271,271,271,271,271,271,271
280,280,280,280,280,280,280,280,280,280,280,280,280,280,280,280,280,280,407,280,280,280,360,280,280,280,280,280,280,405,405,280,280,280,270,271,271,240,316,317,280,280,280,280,280,280,280,280,361,407,362,361,280,280,280,361,280,280,280,280,280,280,225,286,271,271,271,271,271,271,271,271,271,271,271,271,271,271,271,271
280,280,280,280,280,280,280,280,280,280,280,280,280,280,280,280,280,280,362,280,280,406,280,280,280,280,280,280,280,360,280,280,280,280,315,316,316,317,280,280,280,280,280,360,362,280,280,407,406,405,280,280,280,280,280,280,280,280,280,280,280,225,286,240,316,241,271,271,271,271,271,271,271,271,271,271,271,271,271,271
280,280,280,280,280,280,280,280,280,280,280,280,280,280,280,280,280,362,360,361,406,280,280,280,280,280,280,280,406,280,280,280,280,280,280,280,280,280,280,280,280,280,280,280,280,280,280,405,280,280,362,407,280,280,280,280,280,280,280,280,225,286,271,272,225,286,364,365,271,271,271,271,271,271,271,271,271,271,271,271
280,280,280,280,280,280,280,280,280,280,280,280,280,280,280,280,406,361,280,280,280,280,280,280,280,280,362,405,280,280,280,280,280,362,280,280,280,280,280,280,280,280,280,280,280,405,406,280,280,280,280,280,280,280,280,280,280,280,280,280,270,271,271,285,286,271,409,271,271,271,271,271,271,271,271,271,271,271,271,271
280,280,280,280,280,280,280,280,280,280,280,280,280,280,280,280,280,280,280,280,280,280,280,280,405,361,362,280,280,280,280,280,280,280,280,280,280,280,280,280,280,405,405,360,360,405,280,280,280,280,280,280,280,280,280,280,280,280,225,226,286,271,271,271,271,271,271,271,271,271,271,271,271,271,271,271,271,271,271,271
280,280,280,280,280,280,280,280,280,280,280,280,280,280,280,280,280,280,280,280,280,280,280,280,406,280,280,280,280,280,362,280,280,280,280,280,280,280,280,280,280,280,361,360,405,362,280,280,280,280,280,280,280,280,280,280,280,225,286,271,271,271,271,271,365,271,271,271,271,271,271,271,271,271,271,271,271,271,271,271
280,280,280,280,280,280,280,280,280,280,280,280,280,280,280,280,280,280,280,280,280,280,280,280,280,280,280,280,280,280,280,280,280,280,280,280,280,280,280,280,280,407,280,280,280,280,280,280,280,406,280,280,280,280,280,280,225,286,271,365,271,271,271,271,271,271,271,271,271,271,271,271,271,271,271,271,271,271,271,271
280,280,280,280,280,280,280,280,280,280,280,280,280,280,280,280,280,225,226,226,226,226,227,280,280,280,280,280,280,280,280,280,280,280,405,407,280,280,280,280,362,280,280,280,280,280,280,280,405,280,280,280,280,280,280,225,286,271,271,271,271,271,271,271,271,271,271,271,271,271,271,271,271,271,271,271,271,271,271,271
280,280,280,280,280,280,280,280,280,280,280,280,280,280,280,280,225,286,271,408,271,271,272,280,280,280,280,280,280,280,280,280,280,280,280,280,280,280,280,406,280,280,280,280,280,280,280,280,406,361,360,280,280,280,225,286,271,271,271,271,271,271,271,271,271,271,271,271,271,271,271,271,271,271,271,271,271,271,271,271
280,280,280,280,280,280,280,280,280,280,280,280,280,280,280,225,286,271,271,240,316,316,317,280,280,280,280,280,280,280,280,280,280,280,280,280,280,280,280,280,280,406,360,280,280,406,407,362,405,405,406,280,280,225,286,271,271,271,409,271,271,271,271,271,271,271,271,271,271,271,271,271,271,271,271,271,271,271,271,271
280,280,280,280,280,280,280,280,280,280,280,280,280,280,225,286,271,271,240,317,280,280,362,405,280,280,280,280,280,361,280,280,280,280,280,280,280,280,280,280,280,406,405,280,407,407,280,280,280,405,280,280,225,286,271,271,271,271,271,271,271,271,271,271,271,271,271,271,271,271,271,271,271,271,271,271,271,271,271,271
280,280,280,280,280,280,280,280,362,280,280,280,280,280,270,271,271,240,317,280,280,280,360,280,280,280,280,280,280,406,280,280,280,280,280,280,280,280,280,280,280,280,280,361,361,280,280,280,280,280,280,280,270,271,271,271,271,271,271,271,271,271,271,271,271,271,271,271,271,271,271,271,271,271,271,271,271,271,271,271
280,280,280,280,280,280,406,362,280,280,280,280,225,226,286,410,240,317,280,280,280,280,360,280,280,280,280,280,280,280,280,280,280,280,280,280,280,280,280,280,280,407,362,407,280,280,280,280,280,280,280,225,286,271,271,271,271,271,271,271,271,271,271,271,271,271,271,271,271,271,271,271,271,271,271,271,271,271,271,271
280,280,280,280,280,280,407,280,280,280,280,280,270,271,271,271,272,280,280,280,280,280,280,280,280,280,280,280,280,280,360,280,280,280,280,280,280,280,280,280,361,280,280,280,280,280,280,280,280,280,225,286,271,271,271,271,271,271,271,271,271,271,271,271,271,271,271,410,408,271,271,271,271,271,271,271,271,271,271,271
280,280,280,280,280,280,361,280,280,280,280,280,315,241,271,240,317,280,280,280,280,280,280,280,280,280,280,280,280,280,280,280,405,280,280,361,280,280,280,407,280,361,280,280,280,280,280,280,280,225,286,271,271,365,363,271,271,271,271,271,271,271,271,271,271,271,271,271,271,271,271,271,271,271,271,271,271,271,271,271
280,280,280,280,280,280,280,280,280,280,280,280,280,315,316,317,280,280,280,280,280,362,280,280,280,280,280,280,280,280,280,280,280,280,280,280,280,280,280,280,280,405,280,280,280,280,280,280,280,270,271,240,316,241,410,271,271,271,271,271,271,271,271,271,271,271,271,271,271,271,271,271,271,271,271,271,271,271,271,271
280,280,280,280,280,280,280,280,280,280,280,280,280,280,280,280,280,280,280,280,280,405,280,280,280,280,280,280,362,280,280,280,280,280,280,280,280,280,280,280,361,280,280,280,280,361,406,280,225,286,271,285,226,286,271,271,271,271,271,271,271,271,271,271,271,271,271,271,271,271,271,271,271,271,271,365,271,271,271,271
280,280,280,280,280,280,280,280,280,407,280,280,280,280,280,280,280,360,361,280,280,280,280,280,280,280,280,280,280,280,280,280,280,280,280,280,280,280,280,280,280,280,280,280,407,407,280,225,286,271,271,271,271,271,410,271,271,271,271,271,271,271,271,271,271,271,271,271,271,271,271,271,271,271,271,364,271,271,271,271
280,280,280,280,280,280,280,280,280,280,280,280,361,280,280,280,280,280,280,280,280,280,280,280,280,280,280,280,280,280,280,362,280,280,280,360,407,280,280,280,280,280,280,405,280,280,225,286,271,271,271,271,271,271,271,271,271,271,271,271,271,271,271,271,271,271,271,271,271,271,271,271,271,271,271,410,271,271,271,271
280,280,280,280,280,280,280,280,280,280,280,280,280,280,280,280,280,280,280,280,280,406,280,280,280,280,280,280,280,406,360,280,405,361,360,280,280,360,280,280,280,280,280,280,225,226,286,271,271,271,271,271,271,271,271,271,271,271,271,271,271,271,271,271,271,271,363,271,271,271,271,271,271,271,271,271,271,271,271,271
280,280,280,280,280,280,280,280,280,225,226,227,280,280,280,280,280,280,406,361,405,362,280,280,280,280,280,362,362,360,407,361,280,280,280,280,280,280,280,280,280,405,280,225,286,271,271,240,316,241,271,271,271,271,271,271,271,271,271,271,271,271,271,271,271,271,271,271,271,271,271,271,271,271,271,271,271,240,241,271
280,280,280,280,280,280,280,280,280,270,271,272,280,280,280,405,280,280,280,280,280,280,280,280,280,280,280,280,280,280,280,280,280,280,280,280,280,280,280,280,280,225,226,286,271,271,271,272,225,286,271,271,271,271,271,271,271,271,271,271,271,271,271,271,271,271,271,271,271,271,271,271,271,271,271,271,271,272,270,271
280,280,280,280,280,280,280,280,280,270,271,272,280,280,280,407,362,280,280,280,280,280,280,280,280,280,280,280,280,280,280,280,280,280,280,280,280,280,280,225,226,286,271,271,271,271,271,285,286,271,364,271,271,409,271,271,271,271,271,271,271,271,271,271,271,271,271,271,271,271,271,271,271,271,271,271,271,285,286,271
280,280,280,280,280,280,280,280,225,270,271,272,280,280,280,280,280,280,280,280,280,280,280,280,280,280,280,280,280,280,280,280,280,280,280,280,280,280,225,286,271,271,271,271,271,271,271,271,271,271,365,271,271,410,271,271,271,271,271,271,271,271,271,271,271,271,271,271,271,271,271,271,271,271,271,271,271,271,271,271
280,280,280,280,280,280,280,280,280,270,271,272,280,280,280,280,280,280,280,280,280,280,280,407,362,280,280,280,280,280,280,280,280,280,280,280,280,225,286,271,271,271,271,271,271,271,271,271,271,271,271,363,271,271,271,271,271,271,271,271,271,271,271,271,271,271,271,271,409,271,271,271,271,271,271,271,271,271,271,271
280,280,280,280,280,280,280,280,280,270,271,285,226,227,280,280,280,280,280,280,405,280,280,280,280,280,280,280,280,280,360,280,361,280,280,225,226,286,271,271,271,271,271,271,271,271,271,271,271,271,271,271,271,271,271,271,271,271,271,271,271,271,271,271,271,271,271,271,271,271,271,271,271,271,271,271,271,271,271,271
280,280,280,280,280,280,280,225,280,270,271,271,271,272,280,280,280,280,280,280,280,280,280,280,280,280,280,280,280,280,280,280,280,225,226,286,271,271,271,271,271,271,271,271,271,271,271,271,271,271,271,271,271,271,271,271,364,271,410,271,271,271,271,271,271,271,271,271,271,271,271,271,271,271,271,271,271,271,271,271
280,280,280,280,280,280,225,280,225,286,271,271,271,285,227,280,280,280,280,280,280,280,280,280,280,280,280,280,280,280,280,225,226,286,271,271,271,271,271,271,271,271,271,271,271,271,271,271,271,271,271,271,271,271,271,271,271,271,271,271,271,271,271,271,271,409,271,271,271,271,271,271,271,271,271,271,271,271,271,271
280,280,280,280,280,280,270,225,286,271,271,271,409,410,285,226,226,227,280,280,280,280,225,226,226,226,226,226,226,226,226,286,271,271,364,271,271,271,271,271,271,271,271,271,271,271,271,271,271,271,271,271,271,271,271,271,271,271,271,271,271,271,271,271,271,271,410,271,271,271,271,271,271,271,271,271,271,271,271,271
280,280,280,280,280,280,225,286,271,271,271,271,271,271,271,271,271,285,226,226,226,226,286,271,271,271,271,271,271,271,271,271,271,410,271,240,241,271,271,271,271,271,271,271,271,271,271,271,271,271,271,271,271,271,271,271,271,271,271,271,271,271,271,271,271,271,271,271,271,271,271,271,271,271,271,271,271,271,271,271
280,280,280,280,280,225,270,271,271,271,271,271,271,271,271,271,271,271,271,271,365,363,271,271,271,271,271,271,271,271,271,271,271,271,271,285,286,271,271,271,271,271,271,271,271,271,271,271,271,271,271,271,271,271,271,271,271,271,271,271,271,271,271,271,271,271,271,271,271,271,271,271,271,271,271,271,271,271,271,271
280,280,280,280,280,270,270,271,271,271,271,271,271,271,271,271,271,271,271,271,271,271,271,271,271,271,271,271,271,271,271,271,271,271,271,271,271,271,271,271,271,271,271,271,271,271,271,271,271,271,271,271,271,271,271,271,271,271,271,271,271,271,271,271,271,271,271,271,271,271,271,271,271,271,271,271,271,271,271,271
280,280,280,280,280,270,270,271,271,271,271,271,271,271,271,271,271,271,271,271,271,365,364,408,271,271,271,271,271,271,271,271,271,271,271,271,271,271,271,271,240,316,316,241,271,271,271,271,271,271,271,271,271,271,271,271,271,271,271,271,271,271,271,271,271,271,271,271,271,271,271,271,271,271,271,271,271,271,271,271
280,280,280,280,280,270,270,271,271,271,271,271,271,271,271,271,271,271,240,241,271,271,271,363,271,271,271,271,271,271,271,271,271,271,271,271,271,271,271,271,285,226,226,286,271,271,271,271,271,271,271,271,271,271,271,271,271,271,271,271,271,271,271,271,271,271,271,271,271,271,271,271,271,271,271,271,271,271,271,271
280,280,280,280,280,280,270,271,271,271,271,271,271,271,271,271,271,271,285,286,271,271,271,271,240,316,316,316,316,316,316,316,316,316,316,316,316,316,241,271,271,271,271,271,271,271,271,271,271,271,271,271,271,271,271,271,271,271,271,271,271,271,271,271,271,271,271,271,271,271,271,271,271,271,271,271,271,271,271,271
280,280,280,280,280,225,286,271,271,271,271,271,271,271,271,240,241,271,271,271,271,271,240,316,317,280,280,280,280,280,280,280,280,280,280,280,280,280,315,316,316,316,316,241,271,271,271,271,271,271,271,271,271,271,271,271,271,271,271,271,271,271,271,271,271,271,271,271,271,271,271,271,271,271,271,271,271,271,271,271
280,280,225,225,226,286,271,271,271,271,271,271,271,271,271,285,286,271,271,271,240,316,317,280,280,280,280,280,280,280,280,280,280,280,280,280,280,280,280,280,280,280,280,315,316,241,271,271,271,271,271,271,271,271,271,271,271,271,271,271,271,271,271,271,271,240,241,271,271,271,271,271,271,271,271,271,271,271,271,271
280,280,225,286,280,271,271,271,271,271,271,271,271,271,271,271,271,271,240,316,317,280,280,280,280,280,280,280,280,280,280,280,225,226,226,226,226,226,227,280,280,280,280,280,280,315,316,316,241,271,271,271,271,271,271,271,271,271,271,271,271,271,271,271,271,272,315,241,271,271,271,271,271,271,271,271,271,271,271,271
280,225,286,280,271,271,271,271,271,271,271,271,240,316,316,316,316,316,317,280,280,280,280,280,280,280,280,280,225,226,226,226,286,271,271,271,271,271,285,226,226,226,226,227,280,280,280,280,315,241,271,271,271,271,271,271,271,271,271,271,271,271,271,271,271,285,226,286,271,271,271,271,271,271,271,271,271,271,271,271
286,280,280,271,271,271,271,271,271,271,271,240,317,280,280,280,280,280,280,280,280,280,280,280,225,226,226,226,286,271,271,271,271,271,271,271,364,271,271,271,271,271,271,272,280,280,280,280,280,315,316,241,271,271,271,271,271,271,271,271,271,271,271,271,271,271,271,271,271,271,271,271,271,271,271,271,271,271,271,271
271,271,271,271,271,271,271,271,240,316,316,317,280,280,280,280,280,280,280,280,280,280,280,225,286,271,408,364,363,271,271,271,271,271,271,271,271,271,271,271,271,271,271,285,226,227,280,280,280,280,280,270,271,271,271,271,271,271,271,271,271,271,271,271,271,271,271,271,271,271,271,271,271,271,271,271,271,271,271,271
271,271,271,271,271,240,316,316,317,280,280,280,280,280,280,280,280,280,280,280,280,225,226,286,271,271,271,271,271,271,271,271,271,271,271,271,271,271,271,271,271,271,271,408,363,285,227,280,280,280,280,270,271,271,271,271,271,271,271,271,271,271,271,271,271,271,271,271,271,271,271,271,271,271,271,271,271,271,271,271
271,271,271,271,240,317,280,280,280,280,280,280,280,280,280,280,280,280,280,225,226,286,271,271,271,271,271,271,271,271,271,271,271,271,271,271,271,271,271,271,271,271,271,271,365,271,285,227,280,280,280,270,271,271,271,271,271,271,271,271,271,271,271,271,271,271,271,271,271,271,271,271,271,271,271,271,271,271,271,271
271,271,240,316,317,280,280,280,280,280,280,280,280,280,280,280,225,226,226,286,271,271,271,271,271,271,271,271,271,271,271,271,271,271,271,271,271,271,271,271,271,271,271,271,364,408,271,285,226,227,280,270,271,271,271,271,271,271,271,271,271,271,271,271,271,271,271,271,271,271,271,271,271,271,271,271,271,271,271,271
316,316,317,280,280,280,280,280,280,280,280,280,280,280,225,226,286,271,271,240,316,241,271,271,271,271,271,271,271,271,271,271,271,271,271,271,271,271,271,271,271,271,271,271,271,271,271,271,271,272,280,270,271,271,271,271,271,271,271,271,271,271,271,271,271,271,271,271,271,271,271,271,271,271,271,271,271,271,271,271
280,280,280,280,280,280,280,280,280,280,280,280,225,226,240,316,316,241,271,285,226,286,271,271,271,271,271,271,271,271,271,271,271,271,271,271,271,271,271,271,271,271,271,271,271,240,241,271,271,272,280,270,271,271,271,271,271,271,271,271,271,271,271,271,271,271,271,271,271,271,271,240,241,271,271,271,271,271,271,271
280,280,280,280,280,280,280,280,280,280,280,225,286,271,285,226,226,286,271,271,271,271,271,271,271,271,271,271,271,271,271,271,271,271,271,271,271,271,271,271,271,271,271,271,271,285,286,271,271,272,280,270,271,271,271,410,271,271,271,271,271,271,271,271,271,271,271,271,271,271,271,285,286,271,271,271,271,271,271,271
280,280,280,280,280,280,280,280,280,225,226,286,271,271,271,271,271,271,271,271,271,271,271,271,271,271,271,271,271,271,271,271,271,271,271,271,271,271,271,271,271,271,271,271,240,241,364,271,240,317,280,270,271,271,271,271,271,271,271,271,271,271,271,271,271,271,271,271,271,271,271,271,271,271,271,271,271,271,271,271
280,280,280,280,280,280,225,226,226,286,271,364,364,271,271,271,271,271,271,271,271,271,271,271,271,271,271,271,271,271,271,271,271,271,271,271,271,271,271,271,271,271,271,271,285,286,271,240,317,280,280,270,271,240,316,241,271,271,271,271,271,365,271,271,271,271,271,271,271,240,241,271,271,271,271,271,271,271,271,271
280,280,225,226,226,226,286,271,271,271,271,409,365,271,271,271,271,271,271,271,271,271,271,271,271,271,271,271,271,271,271,271,271,271,271,271,271,271,271,271,271,271,271,271,271,240,316,317,280,280,225,286,271,285,226,286,271,271,271,271,271,271,409,408,363,271,271,271,271,285,286,271,271,271,271,271,271,271,271,271
