280,280,280,280,280,280,280,280,280,280,280,280,228,229,229,229,230,280,280,280,280,280,280,280,280,280,280,280,280,280,280,280,280,280,406,361,280,280,280,315,316,241,271,271,271,271,285,226,227,280,280,280,280,280,280,280,280,280,280,280,280,280,280,280,280,225,226,226,286,271,240,316,317,280,280,280,280,280,280,280
280,280,280,280,280,280,280,280,318,319,271,271,271,271,271,319,271,271,271,271,229,230,280,280,280,280,280,280,280,280,280,280,280,280,280,406,280,280,280,280,280,315,241,271,271,271,271,271,285,227,280,280,280,280,280,280,280,280,280,280,280,280,280,280,225,286,271,271,271,271,285,227,280,280,280,280,280,280,280,280
280,280,280,280,280,280,280,280,280,225,271,271,271,271,271,271,271,271,227,271,271,320,280,280,228,229,229,230,280,280,280,280,280,280,280,280,280,280,361,280,280,280,315,316,241,271,271,271,271,285,226,227,280,280,280,280,280,280,280,280,280,280,225,226,286,271,271,271,240,241,271,272,280,280,280,280,280,280,280,280
280,280,280,280,280,280,228,230,225,286,271,271,271,271,271,271,271,271,271,271,271,271,271,271,318,243,274,287,229,229,230,280,280,280,280,280,280,280,280,406,280,280,280,280,315,316,241,271,271,271,271,285,227,280,280,280,280,280,280,225,226,226,286,271,271,271,271,271,272,315,316,317,280,280,280,280,280,280,280,280
280,280,280,280,280,228,242,320,270,271,271,271,271,271,271,271,271,271,271,271,271,271,271,271,271,318,319,319,243,274,287,229,229,230,280,280,280,280,280,280,280,280,280,280,280,280,315,316,241,271,271,271,272,280,280,280,280,280,225,286,271,271,271,271,271,240,316,316,317,280,280,362,362,280,407,280,280,280,280,280
280,280,280,280,228,242,320,225,286,271,271,271,271,271,271,271,271,271,271,271,271,271,271,271,285,271,271,271,271,319,319,319,319,243,229,230,280,280,280,280,280,280,280,280,280,280,280,280,270,271,271,271,285,226,226,227,280,225,286,271,271,271,271,271,240,317,280,280,280,280,280,280,280,280,280,280,280,280,280,280
280,280,280,228,242,320,225,286,271,271,271,271,271,271,271,271,271,271,271,271,271,271,271,271,271,271,271,285,271,271,271,226,227,318,243,287,229,230,280,280,280,280,280,280,280,280,280,280,315,316,241,271,271,271,271,285,226,286,271,271,240,316,316,316,317,280,280,406,361,280,280,280,280,280,280,280,280,280,280,280
280,280,280,273,275,225,286,271,271,271,271,271,271,271,271,271,271,271,271,271,271,271,271,271,271,271,271,271,271,271,271,271,271,227,318,319,243,287,229,230,360,362,360,362,360,280,280,280,280,280,315,316,316,241,271,271,271,271,271,240,317,280,280,280,280,280,280,280,280,280,280,280,280,280,280,280,280,407,360,406
280,280,228,288,275,270,271,271,271,271,271,271,271,271,271,271,271,271,271,271,271,271,271,271,271,271,271,271,271,271,271,271,271,271,271,271,318,319,319,319,243,280,280,280,280,280,280,280,280,280,280,361,407,315,316,316,316,316,316,317,280,280,280,280,280,280,280,280,280,280,280,280,280,280,280,280,280,406,360,405
280,280,273,274,275,270,271,271,271,271,271,271,271,271,271,271,271,271,271,271,271,271,271,271,271,271,271,271,271,271,271,271,271,271,271,271,271,271,226,227,318,243,280,280,361,360,280,280,280,280,280,280,280,280,280,280,405,280,280,280,280,280,280,280,280,280,280,280,280,280,280,360,360,280,280,280,280,280,280,280
280,280,273,274,275,270,271,271,271,271,271,271,271,271,271,271,271,271,271,271,271,271,271,271,271,271,271,271,271,271,271,271,271,271,271,271,271,271,271,271,271,273,229,230,280,362,407,406,280,280,280,280,280,280,280,280,362,280,280,280,280,280,407,280,280,280,280,280,280,280,280,407,280,280,280,280,280,280,280,280
280,280,273,274,275,270,271,271,271,271,271,271,271,271,271,271,271,271,271,271,271,271,271,271,271,271,271,271,271,271,271,271,271,271,271,271,271,271,271,271,271,271,319,320,280,280,405,362,406,362,360,280,280,280,280,360,407,280,280,280,280,280,405,280,280,280,280,280,280,280,280,280,280,280,280,280,280,280,280,280
280,280,273,274,275,270,271,271,271,271,271,271,271,271,271,271,271,271,271,271,271,271,271,271,271,271,271,271,271,271,271,271,271,271,271,271,271,271,271,271,285,271,271,227,280,280,280,280,280,361,280,361,407,407,362,361,280,280,280,280,280,280,280,280,280,280,280,280,280,280,280,280,280,280,280,360,280,280,280,280
280,280,273,274,275,270,271,271,271,271,271,271,271,271,271,271,271,271,271,271,271,271,271,271,271,271,271,271,271,271,271,271,271,271,271,271,271,271,271,271,271,271,271,285,227,280,280,280,280,280,280,280,280,280,280,280,280,280,280,280,280,280,280,280,280,280,280,280,361,280,362,280,280,280,407,362,280,280,280,280
280,280,318,243,275,270,271,271,271,271,271,271,271,240,241,271,271,271,271,271,271,271,271,271,271,271,271,271,271,271,271,271,271,271,271,271,271,271,271,271,271,271,271,271,272,280,280,280,280,280,280,362,406,406,360,406,405,407,280,280,280,280,280,280,280,280,280,280,407,406,362,280,280,280,280,280,280,280,280,280
280,280,280,273,275,315,241,271,271,271,271,271,271,272,270,271,271,240,316,316,316,316,241,271,271,271,271,271,271,271,271,271,271,271,271,271,271,271,271,271,271,271,271,271,272,280,280,280,280,280,280,280,280,280,280,407,280,280,280,280,280,280,280,280,280,405,407,360,361,280,280,280,280,280,280,280,280,280,280,280
280,280,280,318,287,230,270,271,271,271,271,271,271,272,270,271,271,272,280,280,280,280,315,316,316,316,316,316,316,316,316,316,316,316,241,271,271,271,271,271,271,271,271,271,285,227,280,280,280,280,280,280,280,280,280,360,280,280,280,280,280,280,280,406,360,361,280,280,280,280,280,280,280,280,280,280,280,280,280,225
280,280,280,280,273,275,315,241,271,271,271,271,271,285,286,271,240,317,280,280,280,280,280,280,280,280,280,280,280,280,280,280,280,280,315,316,316,241,271,271,271,271,271,271,271,285,227,280,228,229,229,230,280,280,280,280,280,280,280,280,280,407,361,361,280,280,280,280,280,280,280,280,280,280,280,280,280,280,280,270
280,280,280,280,318,287,230,270,271,271,271,271,271,271,271,271,272,280,280,280,280,280,280,280,280,280,280,280,280,280,280,280,280,280,280,280,280,315,316,241,271,271,240,241,271,271,285,227,273,274,274,275,280,280,280,280,280,280,280,280,406,361,280,280,280,280,280,280,280,407,280,280,280,280,280,280,280,280,280,270
280,280,280,280,280,273,275,315,241,271,271,271,271,271,271,271,272,280,280,280,280,280,280,280,280,280,280,280,280,280,280,280,280,280,280,280,280,280,280,315,316,316,317,315,241,271,271,272,318,319,319,320,280,280,280,280,280,280,280,280,280,406,280,280,280,280,280,280,280,407,280,280,280,280,280,280,280,280,280,270
280,280,280,280,280,273,287,230,271,271,271,271,240,241,271,240,317,280,280,280,280,407,280,280,280,405,280,280,280,280,280,280,280,280,280,280,280,280,280,280,280,280,280,280,315,316,316,317,280,280,280,280,280,280,280,280,280,280,280,280,280,280,280,280,280,280,280,280,280,280,280,280,280,280,280,280,280,280,280,270
280,280,280,280,280,273,274,275,271,271,271,271,285,286,240,317,280,280,280,280,280,280,280,280,280,280,280,280,280,280,280,280,280,280,280,280,280,280,280,280,280,280,280,280,280,280,280,280,280,280,280,280,280,280,280,280,280,280,280,280,280,280,280,280,280,280,280,280,280,280,280,280,280,280,280,280,280,280,225,286
280,280,280,280,280,318,243,287,230,271,271,271,271,271,272,280,280,280,280,280,407,280,280,280,280,280,280,361,280,280,280,280,280,280,280,280,280,280,280,280,280,280,280,280,280,280,280,280,280,280,280,280,280,280,280,280,280,280,280,280,280,280,280,280,280,280,407,280,405,407,406,407,280,280,280,280,280,280,270,271
280,280,280,280,280,280,273,274,287,271,271,271,271,271,272,280,280,280,280,280,280,280,280,280,280,280,280,280,361,280,280,280,280,280,362,280,280,280,280,280,280,280,280,280,280,280,280,280,280,280,280,280,280,280,280,280,280,280,280,280,280,280,280,280,280,280,280,280,280,280,280,280,280,280,280,280,280,280,270,271
280,280,280,280,280,280,318,243,274,275,271,271,271,271,272,280,280,280,280,280,280,406,280,280,280,280,280,280,280,361,280,280,280,280,362,406,280,280,280,280,280,280,280,280,280,280,280,280,280,280,280,280,280,280,280,280,280,280,280,280,280,280,280,280,280,280,280,280,280,280,280,280,280,280,280,280,280,280,270,271
280,280,280,280,280,280,280,273,274,287,230,271,271,271,272,280,280,280,280,280,280,360,280,280,280,280,280,280,280,280,280,280,280,360,280,280,280,280,280,280,280,280,280,280,280,280,280,280,280,280,280,280,280,280,280,280,280,280,280,280,280,362,362,362,280,280,280,280,280,280,280,280,280,280,280,280,280,280,270,271
280,280,280,280,280,280,280,318,243,274,275,270,271,271,272,280,280,280,280,280,280,280,280,280,280,280,280,280,280,280,280,280,280,280,280,280,280,280,280,280,280,280,280,280,280,280,280,361,280,280,280,280,280,280,280,280,280,280,280,280,280,406,280,360,280,280,280,280,280,280,280,280,280,280,280,280,280,225,286,271
280,280,280,280,280,280,280,280,273,274,275,270,271,271,285,227,280,280,280,280,280,280,280,280,280,280,280,405,280,280,280,280,280,280,280,280,280,280,280,280,280,280,280,280,280,405,280,280,280,280,361,406,362,280,280,280,280,280,280,280,280,280,280,361,280,280,405,280,280,280,280,280,280,280,280,280,280,270,271,271
280,280,280,280,280,280,280,280,273,274,275,270,271,271,271,272,280,280,280,280,280,280,280,280,280,280,280,361,280,280,280,280,280,280,280,280,280,280,280,280,280,280,280,280,280,280,280,280,280,280,280,280,280,280,280,280,280,280,280,280,280,280,361,362,280,280,362,407,280,280,280,280,280,280,280,280,280,270,271,271
280,280,280,280,280,280,280,280,318,243,275,270,271,271,271,285,227,280,280,280,280,280,360,280,280,280,280,361,280,280,280,407,360,280,280,280,280,280,280,280,280,280,280,280,280,280,280,280,280,280,280,280,280,280,280,280,280,280,280,280,280,280,361,280,280,280,280,280,280,280,280,280,280,280,280,280,280,270,271,271
280,280,280,280,280,280,280,280,280,318,275,270,271,271,271,271,285,227,280,280,280,280,280,280,280,280,280,280,406,361,280,360,280,280,280,280,280,406,407,280,280,280,280,280,280,280,280,280,280,280,280,280,280,280,280,280,280,280,280,280,280,407,280,280,280,280,280,280,280,280,280,280,280,280,280,280,280,270,271,271
280,280,280,280,280,280,280,280,280,280,275,315,241,271,271,271,271,272,280,280,280,280,280,280,280,280,280,280,280,406,406,280,280,280,280,280,280,280,361,361,407,361,360,362,280,280,280,280,280,280,280,280,280,280,361,405,280,280,280,280,280,280,280,280,280,280,280,280,280,280,280,280,280,280,280,280,280,270,271,271
280,280,280,280,280,280,280,280,280,280,320,280,270,271,271,271,271,285,227,280,280,280,280,280,280,280,280,280,280,280,280,280,280,280,280,280,280,280,280,280,280,280,280,280,280,280,280,280,280,280,280,280,280,280,280,405,280,280,280,280,280,280,280,280,280,280,280,280,280,280,280,280,280,280,280,280,280,270,271,271
280,280,280,280,280,280,280,280,280,280,280,280,315,316,241,271,271,271,285,227,280,405,280,280,280,280,280,280,280,280,280,280,280,280,280,280,280,280,280,280,280,280,280,280,280,280,280,280,280,280,280,280,280,280,280,280,280,280,280,280,280,280,280,280,280,280,280,280,280,280,280,280,361,280,280,280,280,270,271,271
280,280,280,280,280,280,280,280,280,280,280,280,280,280,270,271,271,271,271,272,280,280,280,280,280,280,280,280,280,280,280,280,406,280,406,361,406,280,280,280,280,280,280,280,280,280,280,280,280,280,280,280,280,280,280,280,280,280,280,280,280,280,280,280,280,280,280,280,280,280,280,280,280,280,280,280,280,270,271,271
280,280,280,280,280,280,280,280,280,280,280,280,280,280,270,271,271,271,240,317,280,280,280,280,360,280,280,280,280,280,280,280,280,280,280,280,280,406,280,280,280,280,280,280,280,280,361,280,280,280,280,280,280,280,280,280,280,280,280,280,280,280,280,280,280,280,280,280,280,280,406,280,280,280,280,280,280,315,241,271
280,280,280,280,280,280,280,280,280,280,280,280,280,280,315,241,271,271,272,280,280,280,280,361,280,280,280,280,280,280,280,280,280,280,280,280,280,280,280,280,280,280,280,280,280,280,280,280,280,280,280,280,280,280,280,280,280,280,280,280,280,280,280,280,280,280,280,280,362,362,360,280,280,280,280,280,280,280,315,241
280,280,280,280,280,280,280,280,280,280,280,280,280,280,280,270,271,271,285,227,280,280,280,280,280,280,280,280,280,280,280,280,280,280,280,280,280,280,280,280,280,280,280,280,280,280,280,280,280,280,280,280,280,280,280,360,280,280,280,280,280,280,280,280,280,280,280,280,280,280,280,280,280,280,280,280,280,280,280,315
280,280,280,280,280,280,280,280,280,280,280,280,280,280,280,315,241,271,271,285,227,280,280,280,280,280,280,280,280,280,280,280,280,280,280,280,280,280,280,280,280,280,280,280,280,280,280,280,280,280,280,280,280,280,280,361,280,280,280,280,280,280,280,280,280,280,280,280,280,280,280,280,280,280,280,280,280,280,280,280
280,280,280,280,280,280,280,280,280,280,280,280,280,280,280,280,270,271,271,271,272,280,280,280,280,405,280,280,280,280,280,280,280,280,280,280,280,280,280,280,280,280,280,280,280,280,280,280,280,405,407,361,280,280,280,405,280,280,280,280,280,280,280,280,280,361,280,280,280,280,280,280,280,280,280,225,226,227,280,280
280,280,280,280,280,280,280,280,280,280,280,280,280,280,280,280,270,271,271,271,285,227,280,280,280,280,280,280,280,280,280,280,280,280,280,280,280,280,280,280,280,280,280,280,280,280,280,280,280,405,280,407,360,280,406,362,280,280,280,280,360,280,280,280,280,361,280,280,405,280,280,280,280,280,280,270,271,272,280,280
280,280,280,280,280,280,280,280,280,280,280,280,280,280,280,280,315,241,271,271,271,285,227,280,280,280,280,280,280,280,280,361,405,280,280,280,280,280,280,280,280,280,280,280,280,280,280,280,280,280,280,280,280,405,407,280,280,280,280,280,362,280,280,280,280,280,280,407,280,280,280,280,280,280,280,270,271,272,280,280
280,280,280,280,280,280,280,280,280,280,280,280,280,280,280,280,280,270,271,271,271,271,285,227,280,280,280,280,280,280,280,280,280,280,280,280,280,280,280,280,280,280,280,280,280,280,280,280,280,280,280,280,280,280,280,280,280,280,280,280,280,280,280,280,280,280,280,280,280,280,280,280,280,406,280,270,271,272,280,280
280,280,280,280,280,280,280,280,280,280,280,280,280,280,280,280,280,270,271,271,271,271,271,285,227,280,280,280,280,280,280,280,280,280,280,280,280,280,280,280,280,280,280,280,280,280,280,280,280,280,280,280,280,280,280,280,280,280,280,280,280,280,280,280,280,280,280,280,280,280,280,280,280,280,280,270,271,272,280,280
280,280,280,280,280,280,280,280,280,280,280,280,280,280,280,280,280,315,241,271,271,271,271,271,272,280,280,280,280,280,280,280,280,280,280,280,280,280,280,280,280,280,280,280,280,280,280,280,280,280,280,280,280,280,280,280,280,280,280,280,280,280,280,280,280,280,280,280,280,280,280,280,280,280,280,270,271,272,280,280
280,280,280,280,280,280,280,280,280,280,280,280,280,280,280,280,280,280,270,271,271,240,241,271,285,227,280,280,280,280,280,280,280,280,280,280,280,280,280,280,280,280,280,280,280,280,280,280,280,280,280,280,280,280,280,280,280,280,280,280,280,280,280,280,280,280,280,280,280,280,360,280,280,280,225,286,271,272,280,280
280,280,280,280,280,280,280,280,280,280,280,280,280,280,280,280,280,280,315,316,316,317,270,271,271,272,280,280,280,280,280,280,280,280,280,280,280,280,280,406,280,280,405,280,280,280,280,280,361,280,280,280,280,280,280,280,280,280,280,280,280,280,280,280,280,280,280,280,280,362,280,361,280,406,270,271,271,272,280,280
280,280,280,280,280,280,280,280,280,280,280,280,280,280,280,280,280,280,280,280,280,280,315,241,271,285,227,280,280,280,280,280,280,280,280,280,280,280,280,407,362,405,362,280,280,280,280,280,280,280,280,280,280,280,280,280,362,360,280,280,280,280,280,280,280,280,280,280,280,361,280,362,405,406,270,271,240,317,280,280
280,280,280,280,280,280,280,280,280,280,280,280,280,280,280,280,280,280,280,280,280,280,280,270,271,271,272,280,280,280,280,280,280,280,280,280,280,280,280,280,280,280,280,280,361,280,280,280,280,280,280,280,280,280,280,280,280,280,280,280,280,280,280,280,280,280,280,280,280,360,280,280,280,225,286,271,272,280,280,280
280,280,280,280,280,280,280,280,280,280,280,280,280,280,280,280,280,280,280,280,280,280,280,315,241,271,285,227,280,280,280,280,280,280,280,280,280,280,280,280,280,280,280,280,405,280,280,280,280,280,280,280,280,280,280,280,280,280,280,280,280,280,361,280,280,280,280,280,280,280,280,280,280,270,271,271,272,280,280,280
280,280,280,280,280,280,280,280,280,280,280,280,280,280,280,280,280,280,280,280,280,280,280,280,270,271,271,272,280,280,280,280,280,280,280,280,280,280,280,280,280,280,280,280,280,280,280,280,280,280,280,280,280,280,280,280,280,280,280,280,280,280,280,280,280,280,280,280,280,280,280,280,225,286,271,240,317,280,280,280
280,280,280,280,280,280,280,280,280,280,280,280,280,280,280,280,280,280,280,280,280,280,280,280,315,241,271,272,280,280,280,280,280,280,280,280,280,280,280,280,280,280,280,280,280,280,280,280,280,280,280,280,280,280,280,280,280,280,280,280,280,280,280,280,280,280,280,280,280,280,280,225,286,271,271,272,280,280,280,280
280,280,280,280,280,280,280,280,280,280,280,280,280,280,280,280,280,280,280,280,280,280,280,280,280,270,271,285,227,280,280,280,280,280,280,280,280,280,280,280,280,280,280,280,280,280,280,280,280,280,280,280,280,280,280,280,280,280,280,280,280,280,280,280,280,280,280,280,362,280,280,270,271,271,240,317,280,280,280,280
280,280,280,280,280,280,280,280,280,280,280,280,280,280,280,280,280,280,280,280,280,280,280,280,280,270,271,271,285,227,280,280,280,280,280,280,280,280,280,280,280,280,280,280,280,280,280,280,280,280,280,280,280,280,280,280,280,280,280,280,280,280,280,280,280,280,280,280,360,280,225,286,271,240,317,280,280,280,280,280
280,280,280,280,280,280,280,280,280,280,280,280,280,280,280,280,280,280,280,280,280,280,280,280,280,315,241,271,271,285,227,280,280,280,280,280,280,280,280,280,280,280,280,280,280,280,280,280,280,280,280,280,280,280,280,280,280,280,280,280,280,280,280,280,280,280,280,280,405,280,270,271,271,272,280,280,280,280,280,280
280,280,280,280,280,280,280,280,280,280,280,280,280,280,280,280,280,280,280,280,280,280,280,280,280,280,270,271,271,271,272,280,280,280,280,280,280,280,280,280,280,280,280,280,280,280,280,280,280,280,280,280,280,280,280,280,280,280,280,280,280,280,280,280,280,280,280,361,362,280,270,271,240,317,280,280,280,280,280,280
280,280,280,280,280,280,280,280,280,280,280,280,280,280,280,280,280,280,280,280,280,280,280,280,280,280,270,271,271,271,285,227,280,280,280,280,280,280,280,280,407,362,280,280,280,280,280,280,280,280,280,280,280,280,280,280,280,280,280,280,280,280,280,280,280,280,280,405,280,225,286,271,272,280,280,280,280,280,280,280
280,280,280,280,280,280,280,280,280,280,280,280,280,280,280,280,280,280,280,280,280,280,280,280,280,280,315,241,271,271,271,272,280,280,280,280,280,280,280,280,280,361,280,280,280,280,280,280,280,280,280,280,280,280,280,280,280,280,280,280,280,280,280,280,280,280,280,280,225,286,271,240,280,280,280,280,280,280,280,280
280,280,280,280,280,280,280,280,280,280,280,280,280,280,280,280,280,280,280,280,280,280,280,280,280,280,280,315,316,241,271,285,227,280,280,280,280,280,280,280,280,280,280,280,280,280,280,280,280,280,280,280,280,280,280,280,280,280,280,280,280,280,280,280,280,406,360,280,270,271,240,317,280,280,225,226,226,226,227,280
280,280,280,280,280,280,280,280,280,280,280,280,280,280,280,280,280,280,280,280,280,280,280,280,280,280,225,226,226,286,271,271,272,280,280,280,280,280,280,280,280,280,280,406,280,280,280,280,280,280,280,280,360,280,280,362,280,361,280,280,280,280,406,360,407,407,280,225,286,271,272,280,280,280,270,271,271,271,272,280
280,280,280,280,280,280,280,280,280,280,280,280,280,280,280,280,280,280,280,280,280,280,280,280,280,280,270,271,271,271,271,271,272,280,280,280,280,280,280,280,360,280,280,280,280,280,280,280,280,280,280,361,406,280,280,360,407,360,280,280,280,280,280,280,280,280,225,286,271,240,280,280,280,225,286,271,271,271,272,280
280,280,280,280,280,280,280,280,280,280,280,280,280,280,280,280,280,280,280,280,280,280,280,280,280,280,315,241,271,271,271,271,272,280,280,280,280,361,280,280,280,280,280,280,280,280,280,280,280,280,406,405,280,280,280,280,280,280,280,280,280,280,280,280,280,225,286,271,240,280,280,280,225,286,271,271,271,271,285,227
280,280,280,280,280,280,280,280,280,280,280,280,280,280,280,280,280,280,280,280,280,280,280,280,280,280,280,315,241,271,271,271,272,280,280,280,280,405,280,280,280,280,280,280,280,280,280,280,280,362,280,280,280,280,280,280,280,280,280,280,280,280,280,280,225,286,271,271,280,280,280,280,270,271,271,271,271,271,271,272
280,280,280,280,280,280,280,280,280,280,280,280,280,280,280,280,280,280,280,280,280,280,280,280,280,280,280,225,286,271,271,271,272,280,280,280,280,280,280,280,280,280,280,280,280,280,280,280,280,280,280,280,280,280,280,280,280,280,280,280,280,280,280,225,286,271,271,280,280,280,280,225,286,271,271,271,271,271,271,272
280,280,280,280,280,280,280,280,280,280,280,280,280,280,280,280,280,280,280,280,280,280,280,280,280,280,280,270,271,271,271,271,272,280,280,280,280,280,280,280,280,280,280,280,280,280,280,280,280,280,280,280,280,280,280,280,280,280,280,280,280,280,225,286,271,280,280,280,280,280,225,286,271,271,271,271,271,271,271,272
280,280,280,280,280,280,280,280,280,280,280,280,280,280,280,280,280,280,280,280,280,280,280,280,280,280,280,270,271,271,271,271,272,280,280,280,280,280,280,280,280,280,280,280,280,280,280,280,280,280,280,280,280,280,280,280,280,280,280,280,280,225,286,271,280,280,280,280,280,225,286,271,271,271,271,271,271,271,271,285
280,280,280,280,280,280,280,280,280,280,280,280,280,280,280,280,280,280,280,280,280,280,280,280,280,280,280,270,271,271,271,271,272,280,280,280,280,280,280,280,280,280,280,280,280,280,280,280,280,280,280,280,280,280,280,280,280,280,280,280,225,286,271,280,280,280,280,280,280,270,271,271,271,240,241,271,271,271,271,271
280,280,280,280,280,280,280,280,280,280,280,280,280,280,280,280,280,280,280,280,280,280,280,280,280,280,225,286,271,271,271,240,317,280,280,280,280,280,280,280,280,280,280,280,406,280,280,280,280,280,280,280,280,280,280,280,280,280,280,225,286,271,280,280,280,280,280,280,225,286,271,271,240,317,270,271,271,271,271,271
280,280,280,280,280,280,280,280,280,280,280,280,280,280,280,280,280,280,280,280,280,280,280,280,280,280,270,271,271,271,271,272,280,280,280,280,280,280,280,405,280,280,280,280,280,280,280,280,280,280,280,280,280,280,280,280,280,280,225,286,271,280,280,280,280,280,280,225,286,271,271,271,285,226,286,271,271,271,271,271
280,280,280,280,280,280,280,280,280,280,280,280,280,280,280,280,280,280,280,280,280,280,280,280,280,225,286,271,271,271,271,272,280,280,280,280,280,280,280,280,280,280,361,280,280,280,280,280,280,280,280,280,280,280,280,280,280,225,286,271,271,280,280,280,280,280,225,286,271,271,271,271,271,271,271,271,271,271,271,271
280,280,280,280,280,280,280,280,280,280,280,280,280,280,280,280,280,280,280,280,280,280,280,280,280,270,271,271,271,271,240,317,280,280,280,280,280,280,280,280,280,280,405,280,280,280,280,280,280,280,280,280,280,280,225,226,226,286,271,271,280,280,280,280,280,225,286,271,271,271,271,271,271,271,271,271,271,271,271,271
280,280,280,280,280,280,280,280,280,280,280,280,280,280,280,280,280,280,280,280,280,280,280,280,280,270,271,240,316,316,317,280,280,280,280,280,280,280,280,406,405,280,280,280,280,280,280,280,280,280,280,280,225,226,286,271,271,271,271,280,280,280,280,280,225,286,271,271,271,271,271,271,271,271,271,271,271,271,271,271
280,280,280,280,280,280,280,280,280,280,280,280,280,280,280,280,280,280,280,280,280,280,280,280,225,286,271,272,280,280,280,280,280,280,406,280,280,280,280,280,280,280,280,280,280,280,280,280,280,280,280,280,270,271,271,271,271,271,280,280,280,280,280,225,286,271,271,271,271,271,271,271,271,271,271,240,316,241,271,271
280,280,280,280,280,280,280,280,280,280,280,280,280,280,280,280,280,280,280,280,280,280,280,280,270,271,271,272,280,280,280,280,280,407,405,280,280,406,280,280,280,280,280,280,280,280,280,280,280,280,280,280,270,271,271,271,271,240,280,280,280,280,225,286,271,271,271,271,271,271,271,271,271,271,271,285,226,286,271,271
280,280,280,280,280,280,280,280,280,280,280,280,280,280,280,280,280,280,280,280,280,280,280,225,286,271,240,317,280,280,280,280,280,280,280,280,280,361,280,280,280,360,360,280,280,280,280,280,280,280,280,225,286,271,271,271,240,280,280,280,280,225,286,271,271,271,271,271,271,271,271,271,271,271,271,271,271,271,271,271
280,280,280,280,280,280,280,280,280,280,280,280,280,280,280,280,280,280,280,280,280,280,225,286,271,240,317,280,280,280,280,280,280,280,280,280,360,280,280,280,280,280,280,280,280,280,280,280,280,280,225,286,271,271,240,316,280,280,280,280,225,286,271,271,271,271,271,271,271,271,271,271,271,271,271,271,271,271,271,271
280,280,280,280,280,280,280,280,280,280,280,280,280,280,280,280,280,280,280,280,280,225,286,271,271,272,280,280,280,280,280,280,280,280,280,280,280,280,280,280,280,280,280,280,280,280,280,280,280,225,286,271,271,240,317,280,280,280,280,225,286,271,271,271,271,271,271,271,271,271,271,271,271,271,271,271,271,271,271,271
280,280,280,280,280,280,280,280,280,280,280,280,280,280,280,280,280,280,280,280,280,270,271,271,240,317,280,280,280,280,280,280,280,280,280,280,360,280,280,280,280,280,280,280,280,280,280,280,225,286,271,271,240,317,280,280,280,280,280,270,271,271,271,271,271,271,271,271,271,271,271,271,271,271,271,271,271,271,271,271
280,280,280,280,280,280,280,280,280,280,280,280,280,280,280,280,280,280,280,280,225,286,271,240,317,280,280,280,280,280,280,280,280,280,280,280,407,280,406,280,280,280,280,280,280,280,280,225,286,271,271,240,317,280,280,280,280,280,225,286,271,271,271,271,271,271,271,271,271,271,271,271,271,271,271,271,271,271,271,271
280,280,280,280,280,280,280,280,280,280,280,280,280,280,280,280,280,280,225,226,286,271,240,317,280,280,280,280,280,406,407,280,280,280,280,280,280,280,280,280,280,280,280,280,280,280,225,286,271,271,240,317,280,280,280,280,280,280,270,271,271,271,271,271,271,271,240,241,271,271,271,271,271,271,271,271,271,271,271,271
