280,280,280,280,280,280,280,280,280,280,280,280,280,280,280,280,280,280,280,280,280,280,280,280,280,280,280,280,280,280,280,280,280,280,280,280,280,280,280,280,280,280,280,280,280,280,280,280,280,280,280,280,280,280,280,280,280,280,280,280,280,280,280,280,280,280,280,280,280,280,280,280,280,280,280,280,280,280,280,280
280,280,280,280,280,280,280,280,280,280,280,280,280,280,280,280,280,280,280,280,280,280,280,280,280,280,280,280,280,280,280,280,280,280,280,280,280,280,280,280,280,280,280,280,280,280,280,280,280,280,280,280,280,280,280,280,280,280,280,280,280,280,280,280,280,280,280,280,280,280,280,280,280,280,280,280,280,280,280,280
280,280,280,280,280,280,280,280,280,280,280,280,280,280,280,280,280,280,280,280,280,280,280,280,280,280,280,280,280,280,280,280,280,280,280,280,280,280,280,280,280,280,280,280,280,280,280,280,280,280,280,280,280,280,280,280,280,280,280,280,280,280,280,280,280,280,280,280,280,280,280,280,280,280,280,280,280,280,280,280
280,280,280,280,280,280,280,280,280,280,280,280,280,280,280,280,280,280,280,280,280,280,280,280,280,280,280,280,280,280,280,280,280,280,280,280,280,280,280,280,280,280,280,280,280,280,280,280,280,280,280,280,280,280,280,280,280,280,280,280,280,280,280,280,280,280,280,280,280,280,280,280,280,280,280,280,280,280,280,280
280,280,280,280,280,280,280,280,280,280,280,280,280,280,280,280,280,280,280,280,280,280,280,280,280,280,280,280,280,280,280,280,280,280,280,280,280,280,280,280,280,280,280,280,280,280,280,280,280,280,280,280,280,280,280,280,280,280,280,280,280,280,280,280,280,280,280,280,280,280,280,280,280,280,280,280,280,280,280,280
280,280,280,280,280,280,280,280,280,280,280,280,280,280,280,280,280,280,280,280,280,280,280,280,280,280,280,280,280,280,280,280,280,280,280,280,280,280,280,280,280,280,280,280,280,280,280,280,280,280,280,280,280,280,280,280,280,280,280,280,280,280,280,280,280,280,280,280,280,280,280,280,280,280,280,280,406,280,280,280
280,280,280,280,280,280,280,280,280,280,280,280,280,280,280,280,280,280,280,280,280,280,361,405,280,280,280,280,280,280,280,280,280,280,280,280,280,280,280,280,280,280,280,280,280,280,280,280,280,280,280,280,280,280,280,280,280,280,280,280,280,280,280,280,280,280,280,280,280,280,280,280,280,280,280,280,361,280,280,280
280,280,280,280,280,280,280,280,280,280,280,280,280,280,280,280,280,280,280,280,280,362,280,280,280,361,362,280,280,280,280,280,280,280,280,280,280,280,280,280,280,280,280,280,280,280,280,280,280,280,280,280,280,280,280,280,280,280,280,280,280,280,280,280,280,280,280,360,360,405,360,280,361,407,361,405,406,280,280,280
280,280,280,280,280,280,280,280,280,280,280,280,280,280,280,280,280,280,280,280,280,280,280,280,280,280,280,280,280,280,280,280,280,280,280,280,280,280,280,280,280,280,280,280,280,280,280,280,280,407,407,280,280,280,280,280,280,280,280,405,361,406,280,280,280,280,280,280,280,280,280,280,280,280,280,280,280,280,280,280
280,280,280,280,280,280,280,280,280,280,280,280,280,280,280,280,280,280,280,280,280,280,280,280,280,280,280,280,280,280,280,280,280,280,280,280,280,280,280,280,280,280,280,280,280,280,280,280,280,280,280,280,280,280,280,280,280,280,280,280,280,280,280,280,280,280,280,280,280,361,280,280,280,280,280,280,280,280,280,280
280,280,280,280,280,280,280,280,280,280,280,407,360,406,406,406,280,280,280,280,280,280,280,280,280,280,405,361,405,360,280,280,280,361,361,405,280,280,280,280,280,280,280,280,280,405,361,361,360,360,407,362,362,361,280,407,406,405,280,280,280,280,361,406,407,280,280,280,280,280,280,280,280,280,280,280,280,280,280,280
405,360,361,280,280,280,280,280,280,406,360,360,280,280,280,280,280,280,280,280,405,407,405,361,407,361,280,280,280,280,361,406,360,280,280,280,407,280,280,280,280,280,280,280,280,280,280,280,280,280,280,280,280,280,280,280,280,280,280,280,280,280,280,280,280,280,280,280,280,280,280,280,280,280,280,280,280,280,280,280
280,280,280,280,280,280,280,280,280,280,280,280,280,280,280,280,280,280,280,280,280,280,280,280,280,280,280,280,280,280,280,280,280,280,280,280,280,280,280,280,280,280,280,280,280,280,280,280,280,280,280,280,280,280,280,280,280,280,280,280,280,280,280,280,280,280,280,280,280,280,280,280,280,280,280,280,280,280,280,280
280,280,280,280,280,280,280,280,280,280,280,280,280,280,280,280,280,361,280,280,280,280,280,280,280,280,280,280,280,280,280,280,280,280,280,280,280,280,280,280,280,280,280,280,280,280,280,280,280,280,280,280,280,280,280,280,280,280,280,280,280,280,280,280,280,280,280,280,280,280,280,280,280,280,280,280,280,280,280,280
280,280,280,280,280,280,280,280,280,280,280,280,280,280,280,280,280,280,280,280,280,280,280,280,280,280,280,280,280,280,280,280,280,280,280,280,280,280,280,280,280,280,280,280,280,280,280,280,280,280,280,280,280,280,280,280,280,280,280,280,280,280,280,280,280,280,280,280,280,280,280,280,280,280,280,280,280,280,280,280
280,280,280,280,280,280,280,280,280,280,280,280,280,280,280,280,280,280,280,280,280,280,405,360,280,280,280,280,280,280,280,280,280,280,280,280,280,280,280,280,280,280,280,280,280,280,280,280,280,280,280,280,280,280,280,280,280,280,280,280,280,280,280,280,280,280,280,280,280,280,280,280,280,280,280,280,280,280,280,280
280,280,280,280,280,280,280,280,280,280,280,280,280,407,280,360,406,280,280,280,280,280,360,280,406,280,280,280,280,280,280,360,406,407,280,280,280,280,280,280,280,280,280,280,280,280,280,280,280,280,280,280,280,280,280,280,280,280,280,280,280,280,280,280,280,280,280,280,280,280,280,280,280,280,280,280,280,280,280,280
280,280,280,280,280,280,280,280,280,280,280,280,280,280,280,280,405,280,280,280,280,280,280,280,280,280,280,280,280,280,280,280,280,280,280,280,280,280,280,280,280,280,280,280,280,280,280,280,280,280,280,280,280,280,280,280,280,280,280,280,280,280,280,280,280,280,280,280,280,280,280,280,280,280,280,280,280,280,280,280
280,280,280,280,280,280,280,280,280,280,280,280,280,280,280,280,280,280,280,280,280,280,280,280,280,280,280,280,280,280,280,280,280,280,280,280,280,280,280,280,280,280,280,280,280,280,280,280,280,280,280,280,280,280,280,280,280,280,280,280,280,280,280,280,280,280,280,280,280,280,280,280,280,280,280,280,280,280,280,280
280,280,225,226,226,227,280,280,280,280,280,280,280,280,280,280,280,280,280,280,280,280,280,280,280,280,280,280,280,280,280,405,406,280,280,280,280,280,280,280,280,280,280,280,280,361,280,280,280,280,280,280,280,280,280,280,362,406,405,280,280,280,280,280,280,280,280,280,280,280,280,280,280,280,280,280,280,280,280,280
226,226,286,271,271,285,226,226,226,227,280,280,280,280,280,280,280,280,280,280,280,280,280,280,280,280,280,280,280,280,280,280,280,280,280,280,280,280,280,280,280,405,280,280,280,280,280,280,280,280,280,280,280,280,280,280,280,280,280,280,280,407,280,280,280,280,280,280,280,280,280,280,280,280,280,280,280,280,280,280
271,271,410,271,271,271,271,271,271,285,227,280,280,280,280,280,280,280,280,225,226,226,227,280,280,280,280,280,280,280,280,280,280,280,280,280,280,280,280,280,280,280,280,280,280,280,280,280,280,280,280,280,280,280,280,280,280,280,360,362,406,407,280,280,280,280,280,280,280,280,280,280,280,280,280,280,280,280,280,280
241,271,271,409,271,271,271,271,271,271,272,280,280,362,362,280,280,280,280,270,271,271,285,227,280,280,225,226,227,225,226,227,280,280,280,280,280,280,280,280,280,280,280,280,280,280,280,280,280,280,280,280,280,280,280,280,280,280,280,280,280,362,405,280,280,280,280,280,280,280,280,280,280,280,407,280,280,280,280,280
286,271,271,271,271,271,271,408,271,271,272,280,280,280,362,280,280,280,280,315,241,271,271,272,280,225,286,271,285,286,271,272,280,280,280,280,280,280,280,280,280,280,280,280,280,280,280,280,280,280,280,280,280,280,360,280,280,280,280,280,280,280,362,280,280,280,280,280,280,280,280,280,405,362,406,280,280,280,280,280
271,271,271,271,271,271,271,271,271,271,272,280,280,280,360,280,280,280,280,280,270,271,271,272,225,286,271,271,271,271,271,285,227,280,280,280,280,280,280,280,280,280,280,280,280,280,280,280,280,280,280,280,280,280,406,280,280,280,280,280,280,280,280,280,280,280,405,362,360,361,407,362,280,280,280,280,280,280,280,280
271,271,271,271,271,271,271,271,271,240,317,280,280,280,280,280,280,280,280,280,315,316,316,317,270,271,271,271,271,271,271,271,285,226,227,280,280,280,280,280,280,280,280,280,280,280,280,280,280,280,280,280,280,280,280,280,280,280,280,280,280,280,280,360,407,407,280,280,280,280,280,280,280,280,280,280,280,280,280,280
271,240,241,271,271,271,271,271,240,317,280,280,280,407,280,280,280,280,280,280,280,280,280,280,270,271,271,271,271,271,271,271,271,271,285,226,227,280,280,280,280,280,280,280,280,280,280,280,280,406,280,280,280,280,280,280,280,280,280,280,362,407,407,280,280,280,280,280,280,280,280,280,280,280,280,280,280,280,280,280
271,285,286,271,271,271,271,271,272,280,280,280,405,405,280,280,280,280,280,280,280,280,280,280,270,271,271,271,271,271,409,364,271,271,271,271,272,280,280,280,280,280,280,280,280,280,280,280,280,407,362,280,280,280,280,280,360,407,407,405,280,280,280,280,280,280,280,280,280,280,280,280,280,280,280,280,280,360,405,280
271,271,271,271,271,271,271,271,272,280,280,280,406,406,280,280,280,280,280,280,280,280,280,280,270,271,271,271,271,271,271,271,271,271,271,271,285,227,280,280,280,280,280,280,280,280,280,406,280,280,280,406,280,280,361,360,280,280,280,280,280,280,280,280,280,280,280,361,280,280,280,280,280,280,280,280,280,280,362,280
271,271,271,271,271,271,365,271,285,227,280,280,280,280,280,280,280,280,280,280,280,280,280,225,286,271,271,271,271,271,271,271,271,271,271,271,271,285,226,227,280,280,280,280,280,280,280,280,280,280,280,280,280,280,280,280,280,280,280,280,280,280,280,280,280,280,280,280,280,280,280,280,280,280,280,280,280,280,280,280
271,271,271,271,271,271,364,271,271,272,280,280,280,280,361,280,280,280,280,280,280,280,280,270,271,271,271,271,408,271,271,240,241,271,271,271,271,271,271,285,226,227,280,280,280,280,280,280,280,280,280,280,280,280,280,280,280,280,280,280,407,280,280,280,280,280,280,280,362,280,280,280,280,280,280,280,280,280,280,280
271,271,271,271,271,271,364,271,271,272,280,280,280,280,360,280,280,280,280,280,280,280,280,270,271,271,271,271,271,271,271,285,286,271,271,271,271,271,271,271,271,285,227,280,280,280,280,280,280,280,280,280,280,280,280,280,280,280,362,362,407,407,362,406,361,361,362,406,360,406,360,406,361,361,280,280,280,280,280,280
271,271,271,271,271,271,271,271,271,285,227,280,280,280,280,280,280,280,280,280,280,280,225,286,271,271,271,409,271,271,271,271,271,271,271,271,271,271,271,271,271,271,272,280,280,280,280,280,280,280,280,280,362,406,280,280,280,280,280,280,280,280,280,280,280,280,280,280,280,280,280,280,280,280,280,280,280,280,280,280
271,271,271,271,271,271,271,271,271,271,272,280,280,280,280,280,280,280,280,280,280,280,270,365,271,271,271,271,271,271,271,271,271,271,271,271,271,271,271,271,271,271,285,227,280,280,280,280,280,280,280,280,280,280,280,280,280,280,280,280,280,280,280,280,280,280,280,280,280,361,280,280,280,280,280,280,280,280,280,280
271,271,271,271,271,271,271,271,271,271,272,280,280,280,280,280,280,280,280,360,280,280,270,364,364,410,271,271,271,271,271,271,271,271,271,271,271,271,271,364,271,271,271,285,227,280,280,280,280,280,280,280,280,280,280,280,280,280,280,280,280,280,280,280,280,280,280,406,361,280,405,280,280,280,280,280,280,280,280,280
271,271,271,271,271,271,271,271,271,271,272,280,280,280,280,280,280,280,280,280,280,280,270,271,271,271,271,271,271,271,271,271,271,271,271,271,271,271,271,271,363,271,271,271,285,227,280,280,280,280,280,280,280,280,280,280,280,280,280,280,280,280,280,280,280,280,360,406,280,406,360,280,280,280,280,280,280,280,280,280
271,271,271,271,271,271,271,271,271,271,272,280,280,280,280,405,280,280,280,280,280,280,315,241,271,271,271,271,271,271,271,271,271,271,271,271,271,271,271,271,271,271,271,271,271,285,226,227,280,280,405,406,406,360,407,280,280,280,280,280,280,280,280,406,280,280,280,280,280,280,362,280,280,280,280,280,280,280,280,280
271,271,271,271,271,271,271,271,363,271,272,280,280,280,280,407,280,407,280,280,280,280,280,270,271,271,271,408,271,271,271,271,271,271,271,271,271,271,271,271,271,271,271,271,271,271,271,285,227,280,280,280,280,280,280,280,280,280,280,280,280,280,280,361,280,280,280,280,280,407,360,280,280,280,280,280,280,280,280,280
271,271,271,271,271,271,271,271,410,271,272,280,280,280,280,407,280,406,280,280,280,280,280,315,241,271,271,363,271,271,271,271,271,271,271,271,271,271,271,271,271,271,271,271,271,271,271,271,285,227,280,280,280,280,280,280,280,280,280,280,280,280,280,280,280,280,280,280,280,280,280,280,280,280,280,280,280,280,280,280
271,271,271,271,271,271,271,271,271,271,272,280,280,280,280,361,280,280,280,362,280,280,280,280,270,271,271,365,363,271,271,271,271,271,271,271,271,271,271,271,271,271,271,271,271,271,271,271,271,285,226,226,227,280,280,280,407,280,280,280,280,280,280,280,280,280,280,280,280,280,280,280,280,280,280,280,280,280,280,225
271,271,271,271,271,271,271,271,271,271,272,280,280,280,280,362,280,280,280,361,280,280,280,280,315,241,363,271,271,271,271,271,271,271,271,271,271,271,271,271,271,271,271,271,271,271,271,271,271,363,271,271,285,226,226,227,280,280,280,280,280,280,280,280,280,280,280,280,280,280,280,280,280,280,280,225,226,226,226,286
271,271,271,271,271,271,271,271,271,271,272,280,280,280,280,280,280,280,280,360,280,280,280,280,280,315,241,271,363,271,271,410,271,271,271,271,271,271,271,271,271,271,271,271,271,271,271,271,271,271,271,271,271,271,271,285,226,226,226,227,225,226,226,226,226,226,226,226,226,226,226,226,226,226,226,286,271,271,240,241
271,271,271,271,271,271,364,271,271,271,272,280,280,280,280,280,407,280,280,362,280,280,280,280,280,280,270,271,365,271,271,365,408,271,271,271,271,271,271,271,271,271,271,271,271,271,271,271,271,271,271,271,271,271,271,271,271,271,271,285,286,271,271,271,271,271,271,271,271,271,271,271,271,271,271,271,271,240,317,270
271,271,271,271,271,271,410,271,271,240,317,280,280,280,280,280,280,280,280,407,280,280,280,280,280,280,315,241,364,271,271,271,365,363,271,271,271,271,271,271,271,271,271,271,271,271,271,271,271,271,271,271,271,271,271,271,271,409,271,271,271,271,271,271,271,271,271,271,410,271,271,271,271,271,271,271,271,285,226,286
271,271,271,271,271,271,271,271,271,272,280,280,280,280,280,280,280,280,280,361,406,280,280,280,280,280,280,315,241,271,271,271,364,409,271,271,271,271,271,240,241,271,271,271,271,271,271,271,271,271,271,271,271,271,271,271,271,271,271,271,271,271,271,240,241,271,271,271,271,271,271,271,271,271,271,271,271,271,271,271
271,271,271,271,271,271,271,271,271,285,227,280,280,280,280,280,280,280,280,280,280,280,280,280,280,280,280,280,315,316,241,271,271,364,271,363,409,271,271,285,286,271,271,271,271,271,271,271,271,271,271,271,271,271,271,271,271,271,271,271,271,271,271,285,286,271,271,271,271,271,271,271,271,271,271,271,271,271,271,271
271,271,271,271,271,271,271,271,365,271,285,227,280,280,280,280,280,280,280,280,280,280,280,405,280,280,280,280,280,280,315,316,241,271,271,271,364,271,271,271,271,271,271,271,240,241,271,271,271,271,271,271,271,271,271,271,271,271,271,271,271,271,271,271,271,271,271,271,271,271,271,271,271,271,271,271,271,271,271,271
271,271,271,271,271,271,271,271,408,363,271,272,280,280,280,280,280,280,280,280,280,280,280,360,407,280,280,280,280,280,280,280,315,316,241,271,271,271,271,271,271,271,271,271,285,286,271,271,271,271,271,271,271,271,271,271,271,271,271,271,271,271,271,271,271,271,271,271,271,271,271,271,271,271,271,271,271,271,271,271
271,271,271,271,271,271,271,271,271,364,271,285,227,280,280,280,280,280,280,280,280,280,280,280,362,405,280,280,280,280,280,280,280,280,315,241,271,271,271,271,271,271,271,271,271,271,271,271,271,271,271,271,271,271,271,271,271,271,271,271,271,271,271,271,271,271,271,271,271,271,271,271,271,271,271,271,271,271,271,271
271,240,316,241,271,271,271,271,271,271,364,271,285,227,280,280,280,280,280,407,280,280,280,280,280,280,361,280,280,280,361,407,362,362,280,315,316,316,241,271,271,271,271,271,271,271,271,271,271,271,271,271,271,271,271,271,271,271,271,271,271,271,271,271,271,271,271,271,271,271,271,271,271,271,271,271,271,271,271,271
271,272,225,286,271,271,271,271,271,271,271,271,271,285,227,280,280,280,280,361,280,360,362,280,280,280,280,360,360,280,280,280,280,280,280,280,280,280,315,241,271,271,271,410,410,271,271,271,271,271,271,271,271,271,271,271,271,271,271,271,271,271,271,271,271,271,271,271,271,271,271,271,271,271,271,271,271,271,271,271
271,285,286,271,271,271,271,271,271,271,271,271,240,241,285,227,280,280,280,362,280,280,362,361,280,280,280,280,361,405,280,280,280,280,280,280,280,280,280,315,316,241,271,271,363,240,241,271,271,271,271,271,271,271,271,271,271,271,271,271,271,271,271,271,271,271,271,271,271,271,271,271,271,271,271,271,271,271,271,271
271,271,271,271,271,271,271,271,271,271,271,271,272,270,271,285,227,280,280,280,280,280,280,361,361,361,280,280,280,360,407,280,280,406,280,280,280,280,280,280,280,315,241,271,410,285,286,271,271,271,271,271,271,271,271,271,271,271,271,271,271,271,271,271,271,271,271,271,271,271,271,271,271,271,271,271,271,271,271,271
271,271,271,271,271,271,271,271,271,271,271,271,285,286,410,271,285,227,280,280,280,280,280,280,405,407,407,406,280,405,280,361,362,361,280,280,280,280,280,280,280,280,315,241,271,271,271,271,271,240,316,241,271,271,271,271,271,271,271,271,271,271,271,271,271,271,271,271,271,271,271,271,271,271,271,271,271,271,271,271
271,271,271,271,271,271,271,271,271,271,271,271,271,271,409,271,271,285,227,280,280,280,280,280,280,280,361,280,360,407,407,280,280,407,280,280,280,280,280,280,280,280,280,315,241,271,271,271,271,285,226,286,271,271,271,271,271,271,271,271,271,271,271,271,271,271,271,271,271,271,271,271,271,271,271,271,271,271,271,271
271,271,271,271,271,271,271,271,271,271,271,271,271,271,271,271,271,271,285,227,280,280,280,280,280,280,280,405,361,406,361,406,280,361,280,280,280,280,280,280,280,280,280,280,270,410,271,271,271,271,271,271,271,271,271,271,271,271,271,271,271,271,271,271,271,271,271,271,271,271,271,271,271,271,271,271,271,271,271,271
271,271,271,271,271,271,271,271,271,271,271,271,271,271,271,271,271,271,271,272,280,280,280,280,280,280,280,280,280,280,280,407,406,280,280,361,362,405,280,280,280,280,280,280,270,410,271,271,271,271,271,271,271,271,271,240,241,271,271,271,271,271,271,271,271,271,271,271,271,271,271,271,271,271,271,271,271,364,271,271
271,271,271,271,271,271,240,316,316,241,271,271,271,271,271,240,241,363,271,285,226,227,280,280,280,280,280,280,280,280,406,280,360,362,280,405,280,362,405,280,280,280,280,225,286,271,271,271,271,271,271,271,271,271,271,285,240,316,316,241,271,271,271,271,271,271,271,271,271,271,271,271,271,271,271,271,271,408,271,271
271,271,271,271,271,271,285,227,225,286,271,271,271,271,271,285,286,410,271,271,271,272,280,280,280,280,280,280,280,280,362,280,280,405,361,280,405,280,361,280,280,280,280,270,271,271,364,365,271,271,271,271,271,271,271,271,272,225,226,286,271,271,271,271,271,271,271,271,271,271,271,271,271,271,271,365,410,408,271,271
271,271,271,271,271,271,271,285,286,271,271,271,271,271,271,271,271,365,364,271,271,285,227,280,280,280,280,280,280,362,280,280,280,280,280,360,405,280,280,280,280,280,280,270,271,271,271,363,271,271,271,271,271,271,271,271,285,286,271,271,271,271,271,271,271,271,271,271,363,271,271,271,271,271,410,271,271,271,271,271
271,271,271,271,271,271,271,271,271,271,271,271,271,271,271,271,271,271,271,271,271,271,285,226,226,226,226,227,280,361,280,280,280,280,280,280,280,406,280,280,280,280,280,270,271,271,271,364,271,271,271,271,271,271,271,271,271,271,271,271,240,241,271,271,271,271,271,271,271,363,271,271,271,271,271,271,271,271,271,240
271,271,271,271,271,271,271,271,271,271,271,271,271,271,271,271,271,271,271,271,271,271,271,271,271,271,271,285,227,280,280,280,280,280,280,280,280,280,280,280,280,280,280,270,271,271,271,271,271,271,271,271,271,271,271,271,271,271,271,271,285,286,271,271,271,271,409,271,271,271,271,271,271,271,271,271,271,240,316,317
271,271,271,271,271,271,271,271,271,271,271,271,271,271,271,271,271,271,271,271,271,271,271,271,271,271,271,271,272,280,280,407,362,360,280,280,280,280,280,280,280,280,280,270,271,271,271,271,271,271,271,271,271,271,271,271,271,271,271,271,271,271,271,271,271,271,271,364,271,271,271,271,271,271,240,316,316,317,280,280
271,271,271,271,271,271,271,271,271,271,271,271,271,271,271,271,271,271,271,271,240,241,271,271,409,271,271,271,285,226,227,280,280,280,280,280,280,280,280,280,280,280,225,286,271,271,271,271,271,271,271,271,271,271,271,271,271,271,271,271,271,271,271,271,363,271,271,271,271,271,271,240,316,316,317,280,280,280,280,280
271,271,240,241,271,271,271,271,271,271,271,271,271,271,271,271,271,271,271,271,285,286,271,271,271,271,271,365,271,271,285,226,226,226,226,226,226,226,226,226,227,225,286,271,271,271,271,271,271,271,271,271,271,271,271,271,271,271,271,271,271,271,271,271,271,271,271,271,271,271,240,317,280,280,280,280,280,280,280,280
271,271,285,286,271,271,271,271,271,271,271,271,271,271,271,271,271,271,271,271,271,271,271,271,271,271,271,271,363,271,271,271,271,271,271,271,410,271,271,271,285,286,363,271,271,271,271,271,271,271,271,271,271,271,271,271,271,271,271,271,271,271,364,271,271,271,271,271,240,316,317,280,280,280,406,361,280,280,280,280
271,271,271,271,271,271,271,271,271,271,271,271,271,271,271,271,271,271,271,271,271,271,271,271,271,271,271,271,271,271,271,271,271,271,271,271,271,271,271,271,271,271,271,271,271,271,271,271,271,271,271,271,271,271,271,271,271,271,271,271,271,271,271,271,271,271,271,240,317,280,280,280,280,280,280,405,280,280,280,280
271,271,271,271,271,271,271,271,271,271,271,271,271,271,271,271,271,271,271,271,271,271,271,271,271,271,271,271,271,271,271,271,271,271,271,271,271,271,271,271,271,271,271,271,271,271,271,271,271,271,271,271,271,271,271,271,271,271,271,271,271,240,241,271,271,240,316,317,280,280,280,280,280,280,280,280,362,362,361,280
271,271,271,271,271,271,271,271,271,271,271,271,271,271,271,271,271,271,240,241,271,271,271,271,271,271,271,271,271,271,271,271,271,271,271,271,271,271,271,271,271,271,271,271,271,271,271,271,271,271,271,271,271,271,271,271,240,316,241,271,271,285,286,271,240,317,280,280,280,280,280,280,280,280,280,280,280,280,280,280
271,271,271,271,271,271,271,271,271,271,271,271,271,271,240,241,271,271,285,286,271,271,271,271,271,271,271,271,271,271,271,271,271,271,271,271,271,271,271,271,271,271,271,271,271,271,271,271,271,271,271,271,271,271,271,271,285,226,286,271,271,271,271,240,317,280,280,280,280,280,280,280,280,280,280,280,280,280,280,280
271,271,271,271,271,271,271,271,271,271,271,271,271,271,272,315,316,241,271,271,271,271,271,271,271,271,271,271,271,271,271,271,271,271,271,271,271,271,271,271,271,271,271,271,271,271,271,271,271,271,271,271,271,271,271,271,271,271,271,271,271,240,316,317,280,280,280,280,280,280,280,280,280,280,280,280,280,280,280,280
271,271,271,271,271,271,271,271,271,271,271,271,271,271,285,226,226,286,271,271,271,271,271,271,271,271,271,271,271,271,271,271,271,271,271,271,271,271,271,271,271,271,271,271,271,271,271,271,271,271,271,271,271,271,271,271,271,271,271,271,271,272,280,362,280,280,280,280,280,280,280,280,280,280,280,361,280,280,280,280
271,271,271,271,271,271,271,271,271,271,271,271,271,271,271,271,271,271,271,271,271,271,271,271,271,271,271,271,271,271,271,271,271,271,271,271,271,271,271,271,271,271,271,271,271,271,271,271,271,271,271,271,271,410,271,271,271,271,271,271,240,317,280,360,280,280,280,280,280,280,280,280,280,280,280,280,280,280,280,280
271,271,271,271,271,271,271,271,271,271,271,271,271,271,271,271,271,271,271,271,271,271,271,271,271,271,271,271,271,271,271,271,271,271,271,271,271,271,271,271,271,271,271,271,271,271,271,271,271,271,271,271,271,410,271,271,271,271,271,240,317,280,280,405,280,280,280,280,280,280,280,280,280,280,280,280,280,280,280,280
271,271,271,271,271,271,271,271,271,271,271,271,271,271,271,271,271,271,271,271,271,271,271,271,271,271,271,271,271,271,271,271,271,271,271,271,271,271,271,271,271,271,271,271,271,271,271,271,271,271,271,271,271,363,271,271,271,271,240,317,280,280,280,280,280,280,280,280,280,280,280,280,280,280,280,280,280,280,280,225
271,271,271,271,271,271,271,271,271,271,271,271,271,271,271,271,271,271,271,271,271,271,271,271,271,271,271,271,271,271,271,240,241,271,271,271,271,271,271,271,271,271,271,271,271,271,271,271,271,271,271,271,271,365,271,271,271,240,317,280,280,280,280,280,280,280,280,280,280,280,280,280,280,280,280,280,280,280,280,270
271,271,271,271,271,271,271,271,271,271,271,271,271,271,271,271,271,271,271,271,271,271,271,271,271,271,271,271,271,271,271,285,286,271,271,271,271,271,271,271,271,271,271,271,271,271,271,271,271,271,271,271,271,409,271,271,271,272,280,280,280,280,280,280,280,280,280,280,280,280,280,280,280,280,280,225,226,226,226,286
271,271,271,271,271,271,271,271,271,271,271,271,271,271,271,271,271,271,271,271,271,271,271,271,271,271,271,271,271,271,271,271,271,271,271,271,271,271,271,271,271,271,271,271,271,271,271,271,271,271,271,271,271,271,271,271,240,317,280,280,280,280,280,280,280,280,405,280,280,280,280,280,280,280,225,286,271,271,271,271
271,271,271,271,271,271,271,271,271,271,271,271,271,271,271,271,271,271,271,271,271,271,271,271,271,271,271,271,271,271,271,271,271,271,271,271,271,271,271,271,271,271,271,271,271,271,271,271,271,271,271,271,271,271,271,240,317,280,280,280,280,405,280,280,280,280,407,280,225,226,226,226,226,226,286,271,271,271,271,271
271,271,271,271,271,271,271,271,271,271,271,271,271,271,271,271,271,271,271,271,271,271,271,271,271,271,271,271,271,271,271,271,271,271,271,271,271,271,271,271,271,271,271,271,271,271,271,271,271,271,271,271,271,271,240,317,280,280,280,407,360,280,280,280,280,280,280,225,286,271,271,271,271,271,271,271,271,271,271,271
