271,271,271,271,271,271,271,271,271,271,271,271,271,271,271,271,271,271,271,271,271,271,271,271,271,271,271,271,271,271,271,271,271,271,271,271,271,271,271,271,271,271,271,271,271,271,271,271,271,271,271,271,271,271,271,271,271,271,271,271,271,271,271,271,271,271,271,271,271,271,271,271,271,271,271,271,271,271,271,271
271,271,271,271,271,271,271,271,271,271,271,271,271,271,271,271,271,271,271,271,271,271,271,271,271,271,271,271,271,271,271,271,271,271,271,271,271,271,271,271,271,271,271,271,271,271,271,271,271,271,271,271,271,271,271,271,271,271,271,271,271,271,271,271,271,271,271,271,271,271,271,271,271,271,271,271,271,271,271,271
271,271,271,271,271,271,271,271,271,271,271,271,271,271,271,271,271,271,271,271,271,271,271,271,271,271,271,271,271,271,271,271,271,271,271,271,271,271,271,271,271,271,271,271,271,271,271,271,271,271,271,271,271,271,271,271,271,271,271,271,271,271,271,271,271,271,271,271,271,271,271,271,271,271,271,271,271,271,271,271
271,271,271,271,271,271,271,271,271,271,271,271,271,271,271,271,271,271,271,271,271,240,316,241,271,271,271,271,271,271,271,271,271,271,271,271,271,271,271,271,271,271,271,271,271,271,271,271,271,271,271,271,271,271,271,271,271,271,271,271,271,271,271,271,271,271,271,271,271,271,271,271,271,271,271,271,271,271,271,365
271,271,271,240,316,316,241,271,271,271,271,271,271,271,271,271,271,271,271,271,271,285,226,286,271,271,271,271,271,271,271,271,240,241,271,271,271,271,271,271,271,271,271,271,271,271,271,271,271,271,271,271,271,271,271,271,271,271,271,271,271,271,271,271,271,271,271,271,271,271,271,271,271,271,271,271,271,271,271,271
271,271,271,285,226,226,286,271,271,271,271,271,271,271,271,271,271,271,271,271,271,271,271,271,271,271,271,271,271,271,271,271,285,286,271,271,271,271,271,240,241,271,271,271,271,271,271,271,271,240,241,271,271,240,241,271,271,271,271,271,271,271,271,271,271,271,271,271,271,271,365,410,271,271,271,271,271,271,271,271
271,271,271,271,271,271,271,271,271,271,271,271,271,271,271,271,271,271,271,271,271,271,271,271,271,271,271,271,271,271,271,271,271,271,271,271,271,271,271,285,286,271,271,271,271,271,271,271,271,285,286,271,271,272,270,271,271,271,271,271,271,271,271,271,271,271,271,271,271,271,271,408,271,271,271,410,410,271,271,271
271,271,271,271,271,271,271,271,271,271,271,271,271,271,271,271,271,271,271,271,271,271,271,271,271,271,271,271,271,271,271,271,271,271,271,271,271,271,271,271,271,271,271,271,271,271,271,271,271,271,271,271,271,285,286,271,271,271,271,271,271,271,271,271,271,271,271,271,271,271,271,271,271,271,271,409,271,240,316,316
271,271,271,271,271,271,271,271,271,271,271,271,271,271,271,271,271,271,271,271,271,271,271,271,271,271,271,271,271,271,271,271,271,271,271,271,271,271,271,271,271,271,271,271,271,271,271,271,271,271,271,271,271,271,271,271,271,271,271,271,271,271,271,271,271,271,271,271,271,271,271,240,316,316,316,316,316,317,280,280
271,271,271,271,271,271,271,271,271,271,271,271,271,271,271,271,271,271,271,271,271,271,271,271,271,271,271,271,271,271,271,271,271,271,271,271,271,271,271,271,271,271,271,271,271,271,271,271,271,363,409,271,271,271,271,409,271,271,271,271,271,271,271,271,271,271,271,271,240,316,316,317,280,280,280,280,280,280,280,280
240,316,241,271,271,271,271,271,271,271,271,240,316,316,316,316,316,316,241,271,271,240,316,316,316,316,316,316,316,316,241,271,271,271,271,271,271,271,271,271,271,271,271,271,271,408,271,271,271,271,271,271,271,271,271,271,271,271,410,271,271,271,271,271,271,240,316,316,317,280,280,280,280,280,280,280,280,280,280,280
285,226,286,271,271,271,271,240,316,316,316,317,280,280,280,280,360,280,315,316,316,317,280,280,280,280,280,280,280,280,315,241,271,271,271,271,271,271,271,271,271,271,240,241,271,271,271,271,271,271,271,271,271,271,365,271,364,363,271,271,271,271,271,271,240,317,280,280,280,280,280,280,360,361,407,280,280,280,280,280
271,271,271,271,271,240,316,317,280,280,280,280,280,280,280,280,280,280,280,280,280,280,280,280,280,280,362,280,280,280,280,315,316,241,271,271,271,271,271,271,271,271,285,286,271,271,271,271,271,271,271,271,271,271,271,271,271,271,271,271,240,316,316,316,317,280,280,280,280,280,280,280,280,280,280,280,280,280,280,280
271,271,271,240,316,317,280,280,280,280,280,280,280,280,280,280,280,280,405,280,280,280,280,362,280,280,280,280,280,280,280,280,280,315,316,316,316,316,241,271,271,271,240,316,316,316,316,316,316,241,271,271,271,271,271,271,271,240,316,316,317,280,280,280,280,280,280,280,280,280,280,280,280,280,280,280,280,280,280,280
271,271,240,317,280,280,280,280,280,405,280,280,280,280,280,280,280,280,361,280,280,280,280,280,280,280,280,280,280,280,280,280,280,280,280,280,280,280,315,316,316,316,317,280,280,280,280,280,280,315,316,316,316,316,316,316,316,317,280,280,280,280,280,280,280,280,280,280,280,280,280,280,280,280,280,280,280,280,280,280
271,240,317,280,280,280,280,280,361,280,280,406,280,280,280,280,280,280,280,280,280,280,280,280,280,280,280,280,280,280,280,280,280,280,280,280,280,280,280,280,280,280,280,280,280,280,280,280,280,280,280,280,280,280,280,280,280,280,280,280,280,280,280,280,280,280,280,280,280,280,280,280,280,280,280,280,280,280,280,280
316,317,280,280,280,280,280,280,280,280,280,280,280,360,280,280,280,280,280,280,280,280,280,280,280,280,280,280,280,280,280,280,280,280,280,280,280,280,280,280,280,280,280,280,280,280,280,280,280,280,280,280,280,280,280,280,280,280,280,407,360,362,362,360,280,280,280,280,280,280,280,280,280,280,280,280,280,280,280,280
280,280,280,280,360,280,280,280,280,280,280,407,360,280,280,361,280,280,280,280,280,280,280,280,280,280,280,280,280,280,280,280,280,280,407,406,280,280,280,280,280,280,280,280,280,280,280,280,280,280,280,361,361,406,280,280,280,280,280,280,280,280,280,280,280,280,280,362,280,280,280,280,280,280,280,280,280,280,280,280
280,280,280,280,280,280,280,280,280,280,280,280,406,280,361,280,280,280,280,362,280,280,280,362,405,280,280,280,280,280,280,361,280,280,280,360,280,280,280,280,280,280,280,280,280,361,407,280,406,362,407,280,280,280,280,280,280,280,280,280,280,280,280,280,280,280,280,280,280,280,280,280,280,280,280,280,280,280,280,280
280,280,280,280,280,280,405,280,280,280,280,280,280,280,280,362,280,280,280,280,280,280,280,280,407,280,280,280,280,280,280,280,280,280,280,280,361,361,280,280,280,280,280,280,280,406,280,280,280,361,280,280,280,280,280,280,280,280,280,280,280,280,280,280,280,280,280,280,280,280,280,280,280,280,280,280,280,280,280,280
280,361,280,280,280,405,407,280,280,280,280,280,280,280,280,405,280,280,280,280,280,280,280,280,280,280,280,280,280,361,280,280,280,280,280,280,280,280,280,280,280,280,361,280,280,280,280,280,280,406,280,280,280,280,280,280,280,280,280,280,280,280,280,280,280,280,280,280,280,280,280,280,280,280,280,280,280,280,280,280
280,280,280,280,280,280,280,280,280,280,280,280,280,280,280,280,360,280,280,361,280,280,280,280,280,280,280,280,362,406,360,360,280,280,280,280,280,280,280,280,280,280,280,280,280,280,280,280,280,360,280,280,280,280,280,280,280,280,280,361,407,280,280,280,280,280,280,280,280,280,280,280,280,280,280,280,280,280,280,280
280,280,280,280,280,280,280,280,361,280,280,280,280,280,280,280,360,407,280,280,407,280,280,280,280,280,280,280,280,280,280,280,280,280,280,280,280,280,280,280,280,280,280,280,405,280,280,280,280,280,280,280,280,280,280,280,362,280,280,280,280,406,280,280,280,280,280,280,280,280,280,280,280,280,280,280,280,280,280,280
280,280,360,280,280,280,280,280,360,280,361,407,280,280,280,280,280,280,280,280,280,280,280,280,280,280,280,280,280,280,280,280,280,280,280,280,280,280,280,280,280,280,362,280,280,280,280,280,280,360,280,280,280,280,280,280,280,362,361,280,280,280,362,280,280,280,406,280,280,280,280,280,280,360,280,280,280,280,280,280
280,280,280,362,280,280,280,361,280,280,280,280,280,280,407,280,280,280,280,280,280,280,280,361,280,280,280,225,226,226,226,226,226,227,280,280,280,280,280,280,280,280,406,361,280,280,280,280,280,407,406,280,280,280,280,280,280,280,406,280,280,280,362,280,280,280,280,280,280,280,280,280,280,280,280,280,280,280,280,405
280,280,280,362,361,280,361,280,280,280,280,280,280,280,280,280,280,280,280,280,280,280,280,280,280,280,225,286,271,271,271,271,271,285,227,280,280,280,280,280,280,280,280,406,280,280,280,280,280,280,280,361,280,280,280,280,280,280,405,360,280,280,280,406,280,280,280,280,280,280,280,280,280,280,280,280,280,280,360,360
280,362,280,280,280,280,405,280,280,280,280,280,280,280,280,280,361,280,280,280,405,280,280,225,226,226,286,240,241,271,271,240,241,271,285,226,226,226,226,227,280,280,280,280,280,280,280,280,280,280,280,280,280,280,280,280,280,280,280,280,280,280,280,280,280,360,280,280,280,280,280,280,280,280,405,362,280,280,280,280
360,280,280,280,280,280,360,280,280,406,280,280,280,280,280,405,280,280,280,280,280,280,225,286,271,271,271,285,286,271,271,285,286,271,271,271,271,364,271,285,227,280,280,405,280,280,280,280,280,280,280,280,280,280,280,280,280,280,280,280,280,280,280,280,280,280,280,280,280,280,280,280,280,280,280,280,280,280,280,280
280,280,280,280,280,406,280,280,280,405,360,280,280,280,280,280,280,280,280,280,280,225,286,271,271,271,271,271,271,271,271,271,271,271,271,271,271,410,271,271,272,280,361,280,225,226,226,227,280,280,280,280,280,280,280,280,280,280,280,280,280,280,280,280,280,280,280,280,280,280,280,280,280,280,280,280,280,280,280,280
280,280,280,280,280,360,280,280,280,280,280,280,280,280,280,280,280,280,280,280,225,286,271,271,271,271,271,271,271,271,271,271,271,271,271,271,271,271,365,410,272,280,406,280,270,271,271,272,280,280,280,280,280,280,280,280,280,280,280,280,280,280,280,280,280,361,280,280,280,280,280,280,280,280,406,280,280,280,280,280
280,280,361,280,280,405,280,280,280,280,280,280,280,280,280,405,405,280,280,225,286,271,271,271,271,271,271,271,271,271,271,271,271,271,271,271,271,271,271,365,272,280,360,280,315,241,271,285,227,280,280,280,280,406,280,280,280,280,280,280,280,280,280,280,280,280,280,280,280,280,280,362,280,280,406,280,280,280,280,280
280,280,362,280,280,360,280,280,280,280,280,280,280,280,280,280,280,225,226,286,271,271,271,271,271,271,271,271,271,271,271,271,271,271,271,271,271,271,271,240,317,280,362,280,225,286,271,271,285,227,280,280,280,280,280,280,280,280,280,280,280,362,280,280,280,280,280,280,280,280,280,280,280,280,280,280,280,280,280,280
407,280,280,280,280,361,280,280,280,280,280,280,280,280,280,280,280,270,271,271,271,271,271,271,271,271,271,271,271,271,271,271,271,271,271,271,271,271,271,272,280,280,361,280,270,271,271,271,271,272,280,280,280,280,280,280,280,280,280,280,280,280,280,280,280,280,280,280,280,280,280,280,280,362,280,280,280,280,280,280
361,362,407,280,280,405,280,280,280,280,280,280,280,280,280,280,280,270,271,271,271,271,271,271,271,271,271,271,271,271,271,271,271,271,271,271,271,271,240,317,280,280,361,280,315,316,316,241,271,285,227,280,280,406,280,280,280,280,280,280,280,280,280,280,280,280,280,280,280,280,280,280,280,280,280,280,280,280,280,280
406,280,280,280,280,362,280,280,280,280,280,280,280,280,280,280,225,286,271,271,271,271,271,271,271,271,271,271,271,271,271,271,271,271,271,271,271,271,272,280,280,280,406,280,280,280,225,286,271,271,272,280,280,280,280,280,280,280,280,280,280,280,280,280,280,280,280,280,280,280,280,280,280,280,280,280,280,280,280,280
280,280,280,360,280,407,280,280,280,280,280,280,280,280,280,225,286,271,271,271,271,271,271,271,271,271,271,271,271,271,271,271,271,271,271,271,271,271,272,280,280,280,405,280,280,280,270,271,271,271,272,280,280,280,280,280,280,280,280,280,280,360,280,280,280,280,280,280,280,280,280,280,280,280,280,280,280,280,280,280
405,361,406,280,280,280,280,280,280,280,280,280,280,225,226,286,271,271,271,271,271,271,271,271,271,271,271,271,271,271,271,271,271,271,271,271,271,271,272,280,280,280,280,280,280,280,270,271,271,271,272,280,280,280,280,280,280,280,280,280,360,362,280,280,280,280,280,362,280,280,280,280,280,280,280,280,280,280,280,280
280,280,280,280,280,407,280,280,280,280,406,407,225,286,271,271,271,271,271,271,271,271,271,271,271,271,271,271,271,271,271,271,271,271,271,271,271,271,272,407,280,280,280,280,280,280,270,271,363,271,272,280,280,280,280,280,280,280,280,280,280,280,280,280,280,280,280,362,280,280,280,280,280,280,280,280,280,280,280,280
280,280,280,280,280,280,280,280,280,280,280,225,286,271,271,271,271,271,271,271,271,271,271,271,271,271,271,271,271,271,271,271,271,271,271,271,240,316,317,280,280,280,280,280,280,280,270,271,363,271,272,280,280,280,280,280,280,280,280,280,280,280,280,280,280,280,280,280,280,280,280,280,280,280,280,280,280,280,280,280
406,280,407,360,280,280,280,280,280,280,280,270,271,271,271,271,271,271,271,271,271,271,271,271,271,271,271,271,271,271,271,271,271,271,271,240,317,280,280,280,280,280,280,280,280,225,286,271,271,271,272,280,280,280,280,280,280,280,280,280,280,280,280,280,280,280,280,280,280,280,280,280,280,280,280,280,280,280,280,280
407,280,407,362,280,280,280,280,280,280,280,270,271,271,271,271,271,271,271,271,271,271,271,271,271,271,271,271,271,271,271,271,240,316,316,317,280,280,280,280,280,280,280,225,226,286,271,271,271,271,272,280,280,280,280,280,280,280,280,280,280,280,280,280,280,280,280,280,280,280,280,280,280,280,280,280,280,280,280,280
405,280,280,280,280,280,280,280,280,280,280,270,271,271,271,271,271,271,271,271,271,271,271,240,316,316,316,316,316,316,316,316,317,280,280,280,280,280,280,280,280,280,280,270,271,271,271,271,364,271,272,280,280,280,280,405,280,280,280,280,280,280,280,280,280,280,280,280,280,280,280,280,280,280,280,280,280,280,280,280
280,280,280,406,280,280,280,280,280,280,225,286,271,271,271,271,271,271,271,240,316,316,316,317,406,280,280,280,280,280,280,280,280,280,280,280,280,280,280,280,280,280,280,270,271,271,365,271,365,271,272,280,280,406,362,280,280,280,280,280,280,280,280,280,280,280,280,280,280,280,280,280,280,280,280,361,280,280,280,280
280,280,280,362,280,280,280,280,280,280,270,271,271,271,271,271,271,271,240,317,280,280,280,280,280,280,280,280,280,280,280,280,361,280,280,280,280,280,280,280,280,280,280,270,271,271,363,409,271,240,317,280,280,280,280,280,280,280,280,280,280,280,280,280,280,280,280,280,280,280,280,361,405,407,405,280,280,280,280,280
280,280,280,280,280,280,280,280,280,225,286,271,271,271,271,271,240,316,317,280,280,280,280,362,407,407,406,280,280,280,280,280,280,280,280,280,280,280,280,280,280,280,225,286,271,271,365,271,240,317,280,280,280,280,280,280,280,280,280,280,280,280,280,280,280,280,280,280,280,280,280,280,280,280,280,280,280,280,280,280
280,280,280,280,280,280,280,280,225,286,271,271,271,240,316,316,317,280,280,280,280,280,406,405,280,280,280,280,280,280,280,280,280,280,280,280,280,280,280,280,280,280,270,363,363,408,271,271,272,280,280,280,280,280,280,280,280,280,280,280,280,280,280,280,280,280,280,362,280,280,280,280,280,280,280,280,280,280,280,280
280,280,280,280,280,280,225,226,286,271,271,240,316,317,280,280,280,280,280,280,280,280,280,280,280,280,280,280,280,280,280,280,280,280,280,280,280,280,280,280,280,225,286,271,271,271,271,271,272,280,280,280,280,280,280,280,280,280,280,280,280,280,280,360,280,280,280,362,280,280,280,280,280,280,280,280,280,280,280,280
280,280,280,280,225,226,286,271,271,271,240,317,280,280,407,407,280,280,280,280,280,280,280,280,280,280,280,280,280,280,280,280,280,280,280,280,280,280,280,280,225,286,271,271,240,241,271,271,272,280,280,280,280,280,280,280,280,360,280,280,406,280,280,361,280,280,405,280,280,280,280,280,280,280,280,280,280,280,280,280
280,280,225,226,286,271,271,271,240,316,317,280,406,362,280,280,280,280,280,280,280,280,280,280,280,280,280,280,280,280,280,280,280,280,280,280,280,280,225,226,286,271,271,240,317,315,316,316,317,280,280,280,280,280,280,280,280,406,280,280,280,280,280,405,280,280,280,280,280,280,280,280,280,280,280,280,280,280,280,280
225,226,286,271,271,271,240,316,317,280,280,406,407,280,280,280,280,280,280,280,280,280,280,280,280,280,280,280,280,280,280,280,280,280,280,225,226,226,286,271,271,240,316,317,280,280,280,280,280,280,280,280,280,280,280,280,280,280,280,280,280,280,280,280,280,280,280,280,280,280,280,360,280,280,280,280,280,280,280,280
286,271,271,271,240,316,317,280,406,280,405,360,361,280,280,280,280,407,280,280,280,280,280,280,280,280,280,280,280,280,280,280,280,225,226,286,271,271,271,271,240,317,280,280,280,280,280,280,280,280,280,280,280,280,280,280,280,280,280,280,280,280,280,280,280,280,405,280,280,280,280,280,406,280,280,280,280,280,280,280
271,271,240,316,317,280,361,280,280,362,407,280,280,280,280,280,280,280,280,280,280,280,280,280,280,280,280,280,280,280,225,226,226,286,271,271,271,240,316,316,317,280,280,280,280,280,280,280,280,280,280,280,280,280,280,280,280,280,280,280,280,280,280,280,280,280,280,280,280,280,280,280,360,406,280,280,280,280,280,280
271,240,317,280,362,280,280,407,361,280,280,280,280,280,280,280,280,280,280,280,280,280,280,280,280,280,225,226,226,226,286,271,271,271,271,240,316,317,280,280,280,280,280,280,280,280,280,360,280,280,280,280,280,280,280,280,407,280,280,280,280,280,280,280,280,280,280,280,280,280,280,280,280,280,280,280,280,280,280,280
240,317,280,280,280,280,361,280,280,280,280,280,280,280,280,280,280,280,280,280,280,280,280,225,226,226,286,271,271,271,271,271,240,316,316,317,280,280,280,280,280,280,280,280,280,280,280,280,280,280,280,280,280,280,280,280,280,407,280,280,280,280,280,280,280,280,280,280,280,280,280,280,280,280,280,280,280,280,280,280
317,360,280,280,280,280,280,280,280,280,280,280,280,280,280,280,280,280,280,280,280,225,226,286,271,271,271,271,271,271,240,316,317,280,280,280,280,280,280,280,280,280,280,280,280,280,280,280,280,280,280,280,280,280,360,280,280,280,280,280,280,280,280,280,280,280,280,280,280,360,280,280,280,280,280,280,280,280,280,280
280,361,280,280,280,280,280,280,280,280,280,280,280,280,280,225,226,226,226,226,226,286,271,271,271,271,271,271,271,240,317,280,280,280,280,280,280,280,280,280,280,360,362,280,280,280,280,280,280,280,280,280,280,362,362,280,280,360,280,280,280,407,405,280,280,280,280,280,280,280,280,280,280,280,280,280,280,280,280,280
280,280,280,280,280,280,280,280,280,280,280,280,280,280,225,286,271,271,271,271,271,271,271,271,271,240,316,316,316,317,280,280,280,280,280,280,280,280,280,280,280,280,360,280,280,280,280,280,280,280,280,280,280,361,280,405,361,280,280,280,280,280,280,280,280,280,280,280,280,280,280,280,280,280,280,280,280,280,280,280
280,280,280,280,280,280,280,280,280,280,280,280,280,225,286,271,271,271,271,271,271,240,316,316,316,317,280,280,280,280,280,280,280,280,280,280,280,280,280,280,361,407,280,407,280,280,280,280,280,280,280,407,405,280,280,280,280,280,280,280,280,280,280,280,280,280,280,280,280,280,280,280,280,280,280,280,280,280,280,280
280,280,280,280,280,280,280,230,280,280,280,225,226,286,271,271,271,240,316,316,316,317,280,280,280,280,280,280,280,280,280,280,280,280,280,280,280,280,280,280,362,280,280,280,280,280,280,280,280,280,280,280,280,280,280,280,280,280,280,280,280,280,280,280,280,361,362,280,280,280,280,280,280,280,280,280,280,280,280,280
280,280,280,280,280,280,318,320,225,226,226,286,271,271,271,240,316,317,280,280,280,280,280,280,280,280,280,280,280,280,280,280,280,280,280,280,280,280,406,360,280,280,280,280,280,280,280,280,280,280,280,280,280,361,280,280,280,280,280,280,280,280,280,280,280,280,406,280,280,280,280,280,280,280,280,280,280,280,280,280
280,280,280,280,280,280,225,226,286,271,365,271,271,240,316,317,280,280,280,280,280,280,280,280,280,280,280,280,280,280,280,406,406,280,280,280,405,361,280,280,280,280,280,280,280,280,280,280,280,280,280,280,280,407,406,280,280,280,280,280,280,280,280,280,362,362,280,280,406,280,280,280,280,280,280,280,280,280,280,280
280,280,280,280,225,226,286,271,271,271,410,271,240,317,280,280,280,280,280,280,280,280,280,280,280,280,280,280,280,280,280,280,280,280,280,280,407,405,362,280,280,280,280,280,280,280,280,280,280,280,280,280,280,280,280,280,360,360,406,280,280,280,280,280,280,280,280,280,280,407,407,280,280,280,280,280,280,280,280,280
280,280,280,225,286,271,271,271,271,240,316,316,317,280,280,280,280,280,280,360,280,280,280,280,280,280,280,280,280,280,280,280,280,280,280,280,280,280,280,280,280,280,280,280,280,280,280,280,280,280,280,280,280,280,280,280,405,280,280,280,280,280,280,280,280,280,362,280,360,280,361,405,280,280,280,280,280,280,280,280
280,280,225,286,271,271,271,271,240,317,280,280,280,280,280,280,280,280,280,280,280,280,280,280,405,360,362,280,280,280,280,280,280,280,280,280,405,280,280,280,280,280,280,280,280,280,280,280,280,280,280,280,280,280,280,280,280,280,280,280,280,280,280,280,280,280,361,280,280,280,280,280,280,280,280,280,280,280,280,280
280,280,270,271,271,271,271,240,317,280,280,280,280,280,280,280,280,280,280,280,280,280,280,280,280,280,280,280,280,280,280,280,280,280,280,280,405,280,280,280,280,280,280,280,280,280,280,280,280,280,280,361,280,280,280,280,280,280,280,280,280,280,280,280,280,280,406,362,360,280,280,280,280,280,280,280,280,280,280,280
225,226,286,365,364,271,240,317,280,280,280,280,280,280,280,280,280,280,280,280,280,280,280,280,280,280,280,280,280,280,280,280,280,280,361,405,280,280,280,280,280,280,280,280,280,280,280,280,280,280,280,280,280,280,280,280,280,280,280,280,280,280,280,280,280,280,280,280,280,280,280,280,280,280,280,280,280,280,225,226
286,271,271,271,363,364,272,280,280,280,280,280,280,280,280,280,280,407,280,280,280,280,280,280,280,280,280,280,280,280,280,280,280,280,280,280,225,226,226,226,226,226,227,280,280,280,280,280,280,280,280,280,280,280,280,280,280,280,280,280,280,280,280,280,280,280,280,280,280,280,280,280,280,280,280,280,280,225,286,271
271,271,271,271,271,240,317,280,280,280,280,280,280,280,280,361,361,280,280,280,362,406,362,280,280,280,280,280,280,280,280,280,280,280,225,226,286,271,271,271,271,271,285,227,280,280,280,280,280,280,280,280,280,280,280,280,280,280,280,280,280,280,280,280,280,280,280,280,280,280,280,280,280,280,225,226,226,286,271,271
271,271,271,271,240,317,280,280,280,280,280,280,280,280,406,362,407,280,280,280,280,280,280,280,280,280,280,280,280,280,280,280,225,226,286,271,271,271,271,271,271,271,271,285,226,227,280,280,280,280,280,280,280,280,280,280,361,280,280,280,280,280,280,280,280,280,280,280,280,280,280,280,225,226,286,271,271,271,271,271
271,271,271,240,317,280,280,280,280,280,280,280,280,280,280,280,280,280,280,280,280,280,280,280,280,280,280,225,226,226,227,225,286,271,271,271,271,271,271,271,271,271,271,271,271,285,227,280,280,280,280,280,280,280,280,280,361,280,280,280,280,280,280,280,280,280,406,362,280,225,226,226,286,271,271,271,271,271,271,271
271,240,316,317,280,280,280,280,280,280,280,280,280,280,280,280,280,280,280,280,280,280,280,280,280,280,225,286,271,271,285,286,271,271,271,271,271,271,271,271,271,271,271,271,271,271,285,227,280,280,280,280,280,280,280,280,280,280,280,280,361,280,280,280,280,280,280,280,225,286,271,271,240,241,271,271,271,271,271,271
240,317,280,280,362,280,280,280,280,280,280,280,280,280,280,280,280,280,280,280,280,225,226,226,226,226,286,271,271,271,271,271,271,271,271,271,271,271,271,271,271,271,271,271,271,271,271,285,227,280,280,280,280,280,280,280,280,280,361,362,406,280,280,280,280,280,280,280,270,271,271,271,272,270,271,271,271,271,271,271
317,280,280,280,362,360,280,280,280,362,280,280,280,280,280,280,280,280,280,280,280,270,271,271,271,271,271,271,271,271,271,271,271,271,271,271,271,271,271,271,271,271,271,271,271,271,271,271,285,227,280,280,280,280,280,280,362,280,280,361,280,280,280,280,280,280,280,225,286,271,271,271,285,286,271,271,271,271,271,271
280,280,280,407,405,406,280,280,280,361,280,280,280,280,280,280,280,280,280,280,225,286,271,271,271,271,271,271,271,271,271,271,271,271,271,271,271,271,271,271,271,271,271,271,271,363,271,271,365,285,227,280,280,280,280,280,360,280,280,280,280,280,280,280,280,280,280,270,271,271,271,271,271,271,271,271,271,271,409,271
280,280,360,362,280,280,280,280,280,407,280,280,280,280,280,280,280,280,280,225,286,271,271,271,271,240,241,271,271,271,271,271,271,271,271,271,271,271,271,271,271,271,271,271,271,271,271,271,363,271,272,280,280,280,280,280,361,280,280,280,280,280,280,280,280,280,280,270,271,271,271,271,271,271,271,271,271,410,365,271
280,407,362,280,280,280,280,280,280,360,280,280,280,280,280,280,280,280,225,286,271,240,241,271,271,285,286,271,271,271,271,271,271,271,271,271,271,271,271,271,271,271,271,271,271,271,409,410,271,364,272,280,280,280,280,280,361,280,280,280,280,280,407,361,405,280,225,286,271,271,271,271,271,271,240,316,241,365,271,271
407,362,280,280,280,280,280,280,280,280,280,280,280,280,280,280,280,280,270,271,271,285,286,271,271,271,271,271,271,271,271,271,271,271,271,271,271,271,271,271,271,271,271,271,271,271,271,271,271,240,317,280,280,280,280,362,361,280,280,280,280,407,360,280,280,280,270,271,271,271,271,271,271,271,285,226,286,271,271,271
362,280,280,280,280,280,407,280,280,280,280,280,280,280,280,280,280,225,286,271,271,271,271,271,271,271,271,271,271,271,271,271,271,271,271,271,271,271,271,271,271,271,271,271,271,271,271,271,271,272,280,280,280,280,406,280,406,280,280,280,280,280,280,280,280,225,286,271,271,271,271,271,271,271,271,271,271,271,271,271
280,280,280,280,280,280,360,407,280,280,280,280,280,280,225,226,226,286,271,271,271,271,271,271,271,271,271,271,271,271,271,271,271,271,271,271,271,271,271,271,271,271,271,271,271,271,271,271,271,272,280,280,280,362,280,280,280,405,280,405,280,280,280,280,225,286,271,271,271,271,271,271,271,271,271,271,271,240,316,316
280,280,280,280,280,407,406,405,280,280,280,280,280,225,286,271,271,271,271,271,271,271,271,271,271,271,271,271,271,271,271,271,271,240,241,271,271,271,271,271,271,271,271,271,271,271,271,271,271,272,280,362,406,280,280,280,280,280,280,405,280,280,280,225,286,271,271,271,271,271,271,271,271,271,271,271,240,317,280,280
