271,271,271,271,271,271,271,271,271,271,271,271,271,271,271,271,271,271,271,271,271,271,271,271,271,271,271,271,271,271,271,271,271,271,271,271,285,226,227,280,280,280,280,280,280,280,280,280,280,280,280,280,280,280,280,280,362,361,405,280,280,280,280,361,280,280,280,280,280,280,280,280,280,280,280,280,280,280,406,280
271,271,271,271,271,271,271,271,271,271,271,271,271,271,271,271,271,271,271,271,271,271,271,271,271,271,271,271,271,271,271,240,241,271,271,271,271,271,285,226,227,280,225,226,227,280,280,280,280,280,280,280,280,280,280,280,280,362,405,280,280,280,280,280,280,280,280,280,280,280,280,280,280,280,280,280,280,360,407,280
271,271,271,271,271,271,271,271,271,271,271,271,271,271,271,271,271,271,271,271,271,271,271,271,271,271,271,271,271,363,409,285,286,363,409,408,271,271,271,271,285,226,286,271,285,226,227,280,280,280,280,280,280,280,280,280,280,280,406,280,280,280,280,280,280,280,280,280,280,280,280,280,280,280,405,280,280,280,405,280
271,271,271,271,271,271,271,271,271,271,271,271,271,271,271,271,271,271,271,271,271,271,271,271,271,271,271,271,271,271,271,240,316,316,241,271,363,408,364,408,364,363,271,271,271,271,285,226,226,227,280,280,280,280,280,280,280,280,280,280,280,280,280,280,280,280,280,280,280,280,280,280,280,280,280,280,280,280,280,280
271,271,271,271,271,271,271,271,271,271,271,271,271,271,271,271,271,271,271,271,271,271,271,271,271,271,271,271,271,271,271,285,226,227,270,271,271,271,271,271,271,271,271,271,271,271,271,271,271,285,226,226,227,280,280,280,280,280,280,280,280,280,280,280,280,280,280,280,361,280,280,280,280,280,280,280,280,280,280,280
271,271,271,271,271,271,271,271,271,271,271,271,271,271,271,271,271,271,271,271,271,271,271,271,271,271,271,271,271,271,271,271,271,285,286,271,271,271,271,271,271,271,271,271,271,271,271,271,271,271,271,271,285,226,227,280,280,280,280,280,280,280,280,360,360,362,280,280,280,280,280,280,280,280,280,280,280,280,280,280
271,271,271,271,271,240,316,316,316,241,271,271,271,271,271,271,271,271,271,271,271,271,271,271,271,271,271,271,271,240,316,316,241,271,271,271,271,271,271,271,271,271,271,271,271,271,271,271,271,271,271,271,271,271,285,226,226,227,280,280,280,280,280,280,280,280,280,280,280,280,280,280,280,280,280,280,280,280,280,280
271,271,271,271,271,285,226,226,226,286,271,271,271,271,271,271,271,271,271,271,271,271,271,271,271,271,271,271,271,285,226,226,286,271,271,271,271,271,271,271,271,271,271,271,271,271,271,271,271,271,271,271,271,271,271,271,271,285,226,227,280,280,280,280,280,280,280,280,280,280,280,280,280,406,360,280,406,407,280,280
271,271,271,271,271,271,271,271,271,271,271,271,271,271,271,271,271,271,271,271,271,271,271,271,271,271,271,271,271,271,271,271,271,271,271,271,271,271,271,271,271,271,271,271,271,271,271,271,271,271,271,271,271,271,271,271,271,271,271,285,226,226,227,280,280,280,280,280,280,280,280,280,280,280,280,280,280,280,280,280
271,271,271,271,271,271,271,271,271,271,271,271,271,271,271,271,271,271,271,271,271,271,271,271,271,271,271,271,271,271,271,271,271,271,271,271,271,271,271,271,271,271,271,271,271,271,271,271,271,271,271,271,271,271,271,271,271,271,271,271,271,271,285,226,227,280,280,280,280,280,280,280,280,280,407,405,280,280,280,280
271,271,271,271,271,271,271,271,271,271,271,271,271,271,271,271,271,271,271,271,271,271,271,271,271,271,271,271,271,271,271,271,271,271,271,271,271,271,271,271,271,271,271,271,271,271,271,271,271,271,271,271,271,271,271,271,271,271,271,271,271,271,271,271,285,227,280,280,280,280,280,280,280,280,280,280,280,280,280,280
271,271,271,271,271,271,271,271,271,271,271,271,271,271,271,271,271,271,271,240,241,271,271,271,271,271,271,240,316,316,241,271,271,271,271,271,271,271,271,271,271,271,271,271,271,271,271,271,271,271,271,271,271,271,271,271,271,271,271,271,271,271,271,271,271,285,227,280,280,280,280,280,280,280,280,280,280,280,280,280
271,271,271,271,271,271,271,271,271,271,271,271,271,271,271,271,271,271,240,317,270,271,271,271,271,271,240,317,225,226,286,271,271,271,271,271,271,271,271,271,271,271,271,271,271,271,271,271,271,271,271,271,271,271,271,271,271,271,271,271,271,271,271,271,271,271,285,227,280,280,280,280,280,280,280,280,280,280,280,280
271,271,271,271,271,271,271,271,271,271,271,271,271,271,271,271,271,271,285,226,286,271,271,271,271,271,285,226,286,271,271,271,271,271,271,271,271,271,271,271,271,271,271,271,271,271,271,271,271,271,271,271,271,271,271,240,241,271,271,271,271,271,271,271,271,271,271,285,227,280,280,280,280,280,280,280,280,280,280,280
271,271,271,271,271,271,271,271,271,271,271,271,271,271,271,271,271,271,271,271,271,271,271,271,271,271,271,271,271,271,271,271,271,271,271,271,271,271,271,271,271,271,271,271,271,271,271,271,271,271,271,240,241,271,271,285,286,271,271,271,271,271,271,271,271,271,271,271,272,280,280,280,362,280,280,280,280,280,280,280
271,271,271,271,271,271,271,271,240,241,271,271,271,271,271,271,271,271,271,271,271,271,271,271,271,271,271,271,271,271,271,271,271,271,271,271,271,271,271,271,271,240,241,271,271,240,241,271,271,271,240,317,270,271,271,271,271,271,271,271,271,271,271,271,271,271,271,271,285,227,280,280,280,280,280,280,280,280,280,280
271,271,271,271,271,271,271,271,285,286,271,271,271,271,271,271,271,271,271,271,271,271,271,271,271,271,271,271,240,241,271,271,271,271,271,271,271,271,271,271,271,272,270,271,271,285,286,271,271,271,285,226,286,271,271,271,271,271,271,271,271,271,271,271,271,271,271,271,271,272,280,280,280,280,280,280,280,280,280,280
271,271,271,271,271,271,271,271,271,271,271,271,271,271,271,271,271,271,271,271,271,271,271,271,271,271,271,271,285,286,271,271,271,271,271,271,271,271,271,271,271,285,286,271,271,271,271,271,271,271,271,271,271,271,271,271,271,271,271,271,271,271,271,271,271,240,316,241,271,285,227,280,280,280,280,280,280,280,280,280
271,271,271,271,271,271,271,271,271,271,271,271,271,271,271,271,271,271,271,271,271,271,271,271,271,271,271,271,271,363,365,364,364,363,271,271,271,271,271,271,271,271,271,271,271,271,271,271,271,271,271,271,271,271,271,271,271,271,271,271,271,271,271,271,271,285,226,286,271,271,272,280,280,280,280,280,280,280,280,280
271,271,271,271,271,271,271,271,271,271,271,271,271,271,271,271,271,271,271,271,271,271,365,363,363,410,409,363,365,271,271,271,365,271,271,271,271,271,271,271,271,271,271,271,271,271,271,271,271,271,271,271,271,271,271,271,271,271,271,271,271,271,271,271,271,271,271,271,363,271,272,280,280,280,280,280,280,405,280,280
271,271,271,271,271,271,271,271,271,271,271,271,271,271,271,271,271,271,271,271,271,271,271,271,271,410,271,271,271,271,271,271,271,271,271,271,271,410,409,271,271,364,363,271,271,271,271,271,271,271,271,271,271,271,271,271,271,271,271,271,271,271,240,241,271,271,271,271,271,271,272,280,280,280,280,280,280,405,280,280
271,271,271,271,271,271,271,271,271,271,271,271,271,271,271,271,271,271,271,271,271,271,271,271,271,271,271,271,271,271,271,271,271,271,271,271,271,271,271,271,271,271,271,271,271,271,271,271,271,271,271,271,271,271,271,271,271,271,271,271,271,271,285,286,271,271,271,271,271,271,272,280,280,280,280,280,280,280,280,280
271,271,271,271,271,271,271,271,271,271,271,271,271,271,271,271,271,271,271,271,271,271,271,271,271,271,271,271,271,271,271,240,316,316,316,316,316,316,316,241,271,271,271,271,271,271,271,271,271,271,271,271,271,271,271,271,271,271,271,271,271,271,271,271,365,365,271,271,271,271,272,280,280,280,405,280,280,280,280,280
271,271,271,271,271,271,271,271,271,271,271,271,271,271,271,271,271,271,271,271,271,271,271,271,271,271,271,271,271,271,240,317,280,280,280,280,280,280,280,315,241,271,271,271,271,271,271,271,271,271,271,271,271,271,271,271,271,271,271,271,271,271,271,271,408,271,271,271,271,271,272,280,280,280,280,280,280,280,407,280
271,271,271,271,271,271,271,271,271,271,271,271,271,271,271,271,271,271,271,271,271,271,271,271,271,271,271,271,240,316,317,280,280,280,280,280,280,280,280,280,270,271,271,271,271,271,408,271,271,271,271,271,271,271,271,271,271,271,271,271,271,271,271,410,409,271,271,271,271,271,272,280,280,280,280,280,280,280,280,280
271,240,241,271,271,271,271,271,271,271,271,271,271,271,271,271,271,271,271,271,271,271,271,271,271,240,316,316,317,280,280,280,280,280,280,280,280,280,280,280,315,241,271,271,409,271,271,271,271,271,271,271,271,271,271,271,271,271,271,271,271,271,271,364,271,271,271,271,271,271,272,280,280,280,280,280,280,280,280,280
271,285,286,271,271,271,271,271,271,271,271,271,271,271,271,271,271,271,271,271,271,271,271,271,271,272,280,280,280,280,280,280,280,280,280,280,280,280,280,280,280,270,271,271,271,271,271,271,271,271,271,271,271,271,271,271,271,271,271,271,271,271,408,271,271,271,271,364,271,271,272,280,280,280,280,280,280,280,361,280
271,271,271,271,271,271,271,271,271,271,271,271,271,271,271,271,271,271,271,271,271,271,240,316,316,317,280,280,280,280,280,280,280,280,280,361,280,280,280,280,280,270,364,271,271,271,271,271,271,271,271,271,271,271,271,271,271,271,271,271,271,365,271,271,271,271,240,241,271,240,317,280,280,280,280,280,280,280,406,280
271,271,271,271,271,271,271,271,271,271,271,271,271,271,271,271,271,271,271,271,271,240,317,280,280,280,280,280,280,280,280,280,280,280,280,362,280,280,280,280,280,270,363,271,271,271,271,271,271,271,271,271,271,271,271,271,271,271,271,271,271,271,271,271,271,271,272,270,271,272,280,280,280,280,280,280,280,280,362,280
271,271,271,271,271,271,271,271,271,271,271,271,271,271,271,271,271,271,271,271,240,317,280,280,280,280,280,280,280,280,280,361,405,280,280,280,280,280,280,280,280,270,365,271,271,271,271,271,271,271,271,240,241,271,271,271,271,271,271,271,271,271,271,271,271,271,272,270,271,272,280,280,280,280,280,280,280,280,280,280
271,271,271,271,271,271,271,271,271,271,271,271,271,271,271,271,271,271,271,271,272,280,280,280,280,280,280,280,280,280,405,360,280,280,280,280,280,280,280,280,280,270,271,271,271,271,271,271,271,271,271,285,286,271,271,271,271,271,271,271,271,271,271,271,271,271,285,286,271,272,280,280,280,280,280,407,280,280,280,280
271,240,241,271,271,271,271,271,271,271,271,271,271,271,271,271,271,271,271,240,317,280,280,280,280,280,280,280,407,360,280,280,280,280,280,280,280,280,280,280,280,270,241,271,271,271,271,271,271,271,271,271,271,271,271,271,271,271,271,271,271,271,271,271,271,271,271,271,240,317,280,280,280,280,280,280,280,280,280,280
271,285,286,271,271,271,271,271,271,271,271,271,271,271,271,271,240,241,271,272,280,280,280,280,280,280,280,280,405,407,280,280,280,280,280,280,280,280,280,280,280,280,270,271,271,271,271,271,271,271,271,271,271,271,271,271,271,271,271,271,271,271,271,271,271,271,271,271,272,280,280,406,280,280,280,280,280,280,280,280
271,271,271,271,271,271,271,271,271,271,271,271,271,271,271,271,272,315,316,317,280,280,280,280,280,280,280,280,280,280,280,280,280,280,280,280,280,280,280,280,280,280,271,271,271,271,271,271,271,271,271,271,271,271,271,271,271,271,271,271,271,271,271,271,271,271,271,240,317,280,280,280,280,280,280,280,280,280,280,280
271,271,271,271,271,271,271,271,271,271,271,271,271,271,271,240,317,280,280,280,280,280,280,280,280,280,280,280,280,362,280,280,280,280,280,280,280,280,280,280,280,271,271,271,271,271,271,271,271,271,271,271,271,271,271,271,271,271,271,271,271,271,271,271,271,271,271,272,280,280,280,280,280,280,280,280,280,280,280,280
271,271,271,271,271,271,271,271,271,271,271,271,271,271,271,272,280,280,280,280,280,280,280,280,280,280,280,280,280,361,362,280,280,280,280,280,280,280,280,280,270,271,271,271,271,271,271,271,271,271,271,271,271,271,271,271,271,271,271,271,271,271,271,271,271,271,240,317,280,361,280,280,280,280,280,280,280,280,280,280
316,316,241,271,271,271,271,271,271,271,271,271,271,271,240,317,280,280,280,280,280,280,280,280,280,280,280,280,280,361,362,280,280,280,280,280,280,280,280,280,270,271,271,271,271,271,271,271,271,271,271,271,271,271,271,271,271,271,271,271,271,271,271,271,271,240,317,280,280,280,280,280,280,280,280,280,280,407,280,280
226,226,286,271,271,271,271,271,271,271,271,271,271,271,272,280,280,280,280,280,280,280,280,280,280,280,280,280,362,360,406,280,280,280,280,280,280,280,225,226,286,271,271,271,271,271,271,271,271,271,271,271,271,271,271,271,271,271,271,271,271,271,271,271,271,272,280,280,280,280,280,280,280,280,280,280,280,280,280,280
271,271,271,271,271,271,271,271,271,271,271,271,271,240,317,280,280,280,280,280,360,362,280,362,405,280,361,406,280,407,362,280,280,280,280,280,280,280,270,271,271,271,271,271,271,271,271,271,271,271,271,271,271,271,271,271,271,271,271,271,271,271,271,271,271,272,280,280,280,280,280,280,280,280,280,280,280,280,280,280
271,271,271,271,271,271,271,271,271,271,271,271,240,317,280,280,280,280,280,280,280,280,280,280,280,362,280,280,280,280,280,280,280,280,280,280,280,280,315,241,271,271,271,271,271,271,271,271,271,271,271,271,271,271,271,271,271,271,271,271,271,271,271,271,271,272,280,280,280,280,280,280,360,360,280,280,280,280,280,280
271,271,271,271,271,271,271,271,271,271,271,240,317,280,280,280,280,280,280,280,280,280,280,280,405,280,280,280,280,280,280,280,280,280,280,280,280,280,280,270,271,271,271,271,271,271,271,271,271,271,271,271,271,271,271,271,271,271,271,271,271,271,271,271,271,272,280,280,280,405,280,280,280,360,280,280,280,280,280,280
271,271,271,271,271,240,241,271,271,271,240,317,280,280,361,280,280,280,280,280,280,280,280,280,280,280,280,280,280,280,280,280,280,280,280,280,280,280,225,286,271,271,271,271,271,271,271,271,271,271,271,271,271,271,271,271,271,271,271,271,271,271,271,271,271,272,280,280,280,280,280,280,280,280,280,280,280,280,280,280
271,271,271,271,271,285,286,271,271,271,272,280,280,280,360,361,361,362,280,280,280,280,280,280,280,280,280,280,280,280,280,280,280,280,280,280,280,225,286,271,271,271,271,271,271,271,271,271,271,271,271,271,271,271,271,271,271,271,271,271,271,271,271,271,271,272,280,280,280,280,280,280,280,280,280,280,280,280,280,280
271,271,271,271,271,271,271,271,271,271,272,280,280,280,280,280,280,280,361,362,405,280,280,280,280,280,280,280,280,280,280,280,280,280,280,280,225,286,271,271,271,271,271,271,271,271,271,271,271,271,271,271,271,271,271,271,271,271,271,271,271,271,271,271,271,272,280,280,280,280,280,280,280,360,280,280,280,280,280,280
271,271,271,271,271,271,271,271,271,271,285,227,280,280,280,280,280,280,280,280,280,280,280,405,280,280,280,280,280,280,280,280,280,280,280,280,270,271,410,271,271,364,363,271,271,271,271,271,271,271,271,271,271,271,271,271,271,271,271,271,271,271,271,271,240,317,280,280,280,280,280,280,280,280,280,280,280,280,280,280
271,271,271,271,271,271,271,271,271,271,271,272,280,280,280,280,280,280,280,280,280,280,280,362,280,280,280,280,280,280,280,280,280,280,280,225,286,271,363,271,271,271,271,271,271,271,271,271,271,271,271,271,271,271,271,271,271,271,271,271,363,271,271,271,272,280,280,280,280,280,280,280,280,360,280,280,280,280,280,280
271,271,271,271,271,271,271,271,240,241,271,272,280,280,280,280,280,280,280,280,280,280,361,280,280,280,280,280,280,280,280,280,280,280,280,270,271,271,271,408,271,271,271,271,271,271,271,271,271,271,271,271,271,271,271,271,271,271,271,271,271,271,271,271,272,280,280,280,280,406,280,406,280,280,280,280,280,280,280,280
271,271,271,271,271,271,271,240,317,270,271,272,280,280,280,280,361,361,280,280,360,360,280,280,280,280,280,280,280,280,280,280,280,280,225,286,271,271,271,363,271,271,271,271,271,271,271,271,271,271,271,271,271,271,271,271,271,271,271,271,271,271,271,240,317,280,280,280,280,280,280,362,280,280,405,280,280,280,280,280
271,271,271,271,271,363,271,272,280,270,271,272,280,280,280,280,406,405,406,406,280,280,280,280,280,280,280,280,280,280,280,280,280,225,286,271,271,271,271,363,271,271,271,271,271,271,271,271,271,271,271,271,271,271,271,271,271,271,271,271,271,271,271,272,280,280,280,280,280,280,280,280,280,406,407,280,280,280,280,280
271,271,271,271,271,271,240,317,280,270,271,272,280,280,280,360,280,407,405,405,407,280,280,280,280,280,280,280,280,280,280,280,280,270,271,271,271,240,241,408,271,271,271,271,271,271,271,271,271,271,271,271,271,271,271,271,271,271,271,271,271,271,271,272,280,280,280,280,280,280,280,280,280,405,360,280,280,280,280,280
271,271,271,271,271,271,272,280,280,270,271,272,280,405,407,280,280,406,280,280,362,360,280,280,280,280,280,280,280,280,280,280,280,270,240,241,271,285,286,364,271,271,271,271,271,271,271,271,271,271,271,271,271,271,271,271,271,271,271,271,271,271,240,317,280,280,280,280,280,280,280,280,280,362,360,280,280,280,280,280
271,271,271,271,271,240,317,280,280,270,271,272,280,406,280,280,280,407,280,280,280,280,361,280,280,280,280,280,280,280,280,280,225,286,272,270,271,271,271,409,271,271,271,271,271,271,271,271,271,271,271,271,271,271,271,271,271,271,240,241,271,271,272,280,280,280,280,280,280,280,280,280,280,407,361,280,280,280,280,280
271,271,271,271,271,272,280,280,225,286,271,272,280,280,280,280,280,280,360,280,280,280,280,280,280,280,280,280,280,280,280,280,270,271,272,270,271,271,271,409,271,271,271,271,271,271,271,271,271,271,271,271,271,271,271,271,271,240,317,270,409,240,317,280,280,280,280,280,280,280,407,280,280,361,280,280,280,280,280,280
409,408,271,271,240,317,280,280,270,271,271,285,227,280,280,280,280,280,361,280,280,280,280,280,280,280,280,280,280,280,280,280,270,271,272,270,271,271,271,410,271,271,271,271,271,271,271,271,271,271,271,271,240,241,271,271,271,272,225,286,240,317,280,280,280,280,280,280,280,280,280,280,407,360,280,280,280,280,280,280
363,271,271,271,272,280,280,280,270,271,271,271,272,280,280,280,280,280,407,280,280,280,280,280,280,280,280,280,280,280,280,280,270,271,285,286,271,271,271,408,271,271,271,271,271,271,271,271,271,240,241,271,272,270,271,271,271,272,270,271,272,280,280,280,280,280,280,280,280,280,280,280,362,361,280,280,280,280,280,280
271,271,271,240,317,280,280,280,270,271,271,271,272,280,280,280,280,280,280,362,280,280,280,280,280,280,280,280,280,280,280,225,286,271,271,271,271,271,271,271,271,271,271,271,271,271,271,271,271,285,286,271,285,286,271,271,271,285,286,240,317,280,280,280,280,280,280,280,280,280,280,361,280,361,280,280,280,280,280,280
271,271,271,272,280,280,280,280,270,271,271,271,272,280,280,280,280,280,280,280,280,280,280,280,360,280,280,280,280,280,280,270,271,271,271,271,271,271,271,271,271,271,271,271,271,271,271,271,271,271,271,271,271,271,271,271,271,271,240,317,280,280,280,280,280,280,280,280,280,280,361,280,280,280,280,280,280,280,280,280
271,271,240,317,280,280,280,280,270,271,271,271,272,280,280,280,280,280,280,280,280,280,280,280,405,280,280,280,280,280,280,270,271,240,241,271,271,271,271,271,271,271,271,271,271,271,240,241,271,271,271,271,271,271,271,271,271,240,317,280,280,280,280,280,280,280,280,280,280,280,280,280,280,280,280,280,280,280,280,280
271,271,272,280,280,280,406,225,286,271,271,271,272,280,280,280,280,280,280,280,280,280,280,361,280,280,280,280,280,280,225,286,240,317,270,271,271,271,271,271,271,271,271,271,271,271,285,286,271,271,271,271,271,271,271,271,240,317,280,280,280,280,280,280,280,406,280,280,361,280,280,280,280,280,280,280,280,280,280,280
271,240,317,280,280,280,405,270,271,271,271,271,272,280,280,280,280,280,280,280,280,405,362,407,280,280,280,280,280,280,270,271,285,226,286,271,271,271,271,271,271,271,271,271,271,271,271,271,271,271,271,271,240,241,271,240,317,280,280,280,280,280,280,280,280,280,280,280,280,280,280,280,280,280,280,280,280,280,280,280
271,272,280,280,280,280,407,270,271,271,271,271,272,280,280,280,280,280,280,407,406,280,280,280,280,280,280,280,280,280,270,271,271,271,271,271,271,271,271,271,271,271,271,271,271,271,271,271,271,240,241,271,272,270,271,272,280,280,280,280,280,280,280,280,280,280,280,280,280,280,280,280,280,280,280,280,280,280,280,280
240,317,280,280,280,280,225,286,271,271,271,240,317,280,280,280,280,280,280,280,280,280,280,280,280,280,280,280,280,280,270,271,271,271,271,271,271,271,271,271,271,271,271,271,271,271,271,271,271,272,270,271,285,286,271,272,280,280,280,280,280,280,280,280,280,280,280,280,280,280,280,280,280,280,280,280,280,280,280,280
317,280,280,280,280,280,270,271,271,271,271,272,280,280,280,280,280,280,280,280,280,280,280,280,406,280,280,280,280,225,286,271,271,271,271,271,271,271,271,240,316,241,271,271,271,271,271,271,271,285,286,271,271,271,240,317,280,280,280,280,280,280,280,280,280,280,280,280,280,280,280,280,280,280,280,280,280,280,280,280
280,280,280,280,406,225,286,271,271,271,271,272,280,280,280,280,280,280,280,280,361,280,280,407,406,280,280,280,280,270,271,271,271,271,271,271,271,271,271,285,226,286,271,271,271,271,271,271,271,271,271,271,240,316,317,280,280,280,280,406,280,280,280,280,280,280,280,280,280,280,280,406,280,280,280,280,280,280,280,280
280,280,280,280,361,270,271,271,271,271,240,317,280,280,280,280,280,280,280,280,406,280,280,280,280,362,362,280,280,270,271,240,241,271,271,271,271,271,271,271,271,271,271,271,271,271,271,271,271,271,271,240,317,280,280,280,280,280,280,280,280,280,280,280,280,280,280,280,280,280,280,405,280,280,280,280,280,280,280,280
280,280,280,280,225,286,271,271,271,271,272,280,280,280,280,280,280,280,280,280,362,280,280,280,280,280,406,280,225,286,271,285,286,271,271,271,271,271,271,271,271,271,271,271,271,271,271,271,271,271,240,317,280,280,280,280,280,280,280,280,280,280,280,280,280,280,280,280,280,280,280,280,280,280,280,280,280,280,280,280
280,280,280,280,270,271,271,271,271,240,317,280,280,280,280,280,280,280,280,280,280,280,407,280,280,280,280,280,270,271,271,271,409,271,271,271,271,271,271,271,271,271,271,271,271,271,271,271,240,316,317,280,280,280,280,280,280,280,280,280,280,280,406,280,280,280,407,360,280,280,280,280,280,280,280,280,280,280,280,280
280,280,280,280,270,271,271,271,271,272,280,280,280,280,280,280,280,280,280,280,280,280,362,280,280,280,280,280,270,271,271,410,271,271,271,271,271,271,271,271,271,240,316,241,271,271,271,240,317,280,280,280,280,280,280,280,280,280,280,280,280,280,406,280,280,280,280,280,280,280,280,280,280,280,280,280,280,280,280,280
227,280,280,225,286,271,271,271,240,317,280,280,280,280,280,280,280,280,407,406,280,280,360,405,280,280,280,280,270,271,271,365,271,271,271,271,271,271,271,271,271,285,226,286,271,271,240,317,280,407,362,407,362,280,280,280,405,362,280,280,280,280,405,280,280,280,280,280,405,280,280,280,280,280,280,280,280,280,280,280
272,280,280,270,271,271,271,271,285,227,280,280,280,280,280,280,280,361,280,280,280,280,405,407,280,280,280,280,270,271,271,363,271,271,271,271,271,271,271,271,271,271,271,271,240,316,317,280,280,280,280,280,280,362,361,407,280,405,280,280,280,361,280,280,280,280,280,280,280,280,280,280,280,280,280,280,280,280,280,280
285,226,227,270,271,271,271,271,271,272,280,280,280,280,280,280,361,280,280,280,280,280,280,407,280,280,280,280,270,271,271,408,271,271,271,271,271,271,271,240,241,271,271,271,272,280,280,280,280,280,280,280,280,280,280,280,280,280,280,280,280,280,280,280,280,280,280,280,280,280,280,280,280,280,280,280,280,280,280,280
271,271,285,286,271,271,271,271,271,272,280,280,280,280,280,280,280,280,280,280,280,280,280,361,407,280,280,280,270,271,271,364,271,271,271,271,363,271,409,285,286,271,271,240,317,280,280,280,280,280,361,280,280,280,280,407,406,280,280,280,280,280,280,280,280,280,280,280,280,280,280,280,280,280,280,280,280,280,280,280
271,271,271,271,271,271,271,271,271,272,280,280,280,280,280,280,280,280,280,280,280,280,280,362,280,280,280,280,270,271,271,271,271,271,271,271,271,271,271,271,271,271,240,317,280,280,280,280,280,280,280,280,280,280,280,280,405,280,280,280,280,280,280,280,280,280,280,280,280,280,280,280,280,280,280,280,280,280,280,280
271,271,271,271,271,271,271,271,271,285,227,280,280,280,280,280,280,280,280,280,280,280,280,280,362,280,280,280,315,316,316,316,316,241,271,271,271,271,271,240,316,316,317,280,280,280,280,280,280,362,280,280,280,280,280,280,280,280,360,280,280,280,280,280,280,280,280,280,280,280,280,280,280,280,280,280,280,280,280,280
271,271,271,271,271,271,271,271,271,271,285,227,280,280,280,360,280,280,280,280,280,280,280,280,280,280,280,280,280,280,280,280,280,315,316,316,316,316,316,317,280,280,280,280,280,280,280,280,280,280,280,280,280,280,280,280,280,280,280,280,280,280,280,280,280,280,280,280,280,280,280,280,280,280,280,280,280,280,280,280
271,271,271,271,271,271,271,271,271,271,271,272,280,280,280,407,280,280,280,280,280,280,280,280,280,280,280,280,280,280,280,280,280,280,280,280,280,280,280,280,280,280,280,280,280,280,280,280,280,280,280,280,280,280,280,280,280,280,280,280,280,280,280,280,280,280,280,280,280,280,280,280,280,280,280,280,280,280,280,280
271,271,271,271,271,271,271,271,271,271,271,272,362,280,280,405,407,280,280,280,280,280,280,280,280,280,280,280,280,280,280,280,280,280,280,280,280,280,280,280,280,280,280,280,280,280,280,280,280,280,280,280,280,280,280,280,280,406,280,280,280,280,280,280,280,280,280,280,280,280,280,280,280,280,280,280,280,280,280,280
271,271,271,271,271,271,271,410,410,271,271,272,405,361,407,280,280,280,280,280,280,280,280,280,407,280,280,280,280,280,280,280,280,280,280,280,280,280,280,280,280,280,280,280,280,280,280,362,362,280,280,280,280,280,361,280,280,280,280,280,280,280,361,280,280,280,280,280,280,280,280,280,280,280,280,280,280,280,280,280
271,271,271,271,271,271,271,271,365,271,271,272,280,280,361,407,405,280,280,280,280,280,280,280,407,280,280,280,280,280,280,280,280,280,280,280,280,280,280,280,280,280,280,280,280,280,280,360,280,280,280,280,280,280,280,280,280,405,280,280,280,280,280,280,280,280,280,280,280,280,280,280,280,280,280,280,280,280,280,280
271,271,271,271,271,271,271,271,271,271,364,272,280,280,280,280,280,280,280,280,280,280,280,280,280,280,280,280,280,280,280,280,280,280,280,280,280,280,280,280,280,280,280,280,280,280,280,280,280,280,280,280,280,280,280,280,280,280,280,280,280,280,280,280,280,280,280,280,280,280,280,280,280,280,280,280,280,280,280,280
