280,280,280,280,280,280,280,280,280,280,280,280,280,280,280,280,280,280,280,280,280,280,280,280,280,280,280,280,280,280,280,280,280,280,280,280,280,280,280,280,280,280,280,280,280,280,280,280,280,280,280,280,280,280,280,280,280,280,280,280,280,280,280,280,280,280,280,280,280,280,280,280,280,280,280,280,280,280,280,280
280,280,280,280,280,280,280,280,280,280,280,280,280,280,280,280,280,280,280,280,280,280,280,280,280,280,280,280,280,280,280,280,280,280,280,280,280,280,280,280,280,280,280,280,280,280,280,280,280,280,280,280,280,280,280,280,280,280,280,280,280,280,280,280,280,280,280,280,280,280,280,280,280,280,280,280,280,280,280,280
280,280,280,280,280,280,280,280,280,280,280,280,280,280,280,280,280,280,280,280,280,280,280,280,280,280,280,280,280,280,280,280,280,280,280,280,280,280,280,280,280,280,280,280,280,280,280,280,280,280,280,280,280,280,280,280,280,280,280,280,280,280,280,280,280,280,280,280,280,280,280,280,280,280,280,280,280,280,280,280
280,280,280,280,280,280,280,280,280,280,280,280,280,280,280,280,280,280,280,280,280,280,280,280,280,280,280,280,280,280,280,280,280,280,280,280,280,280,280,280,280,280,280,280,280,280,280,280,280,280,280,280,280,280,280,280,280,280,280,280,280,280,280,280,280,280,280,280,280,280,280,280,280,280,280,280,280,280,280,280
280,280,280,280,280,280,280,280,280,280,280,280,280,280,280,280,280,280,280,280,280,280,280,280,280,280,280,280,280,280,280,280,280,280,280,280,280,280,280,280,280,280,280,280,280,280,280,280,280,280,280,280,280,280,280,280,280,280,280,280,280,280,280,280,280,280,280,280,280,280,280,280,280,280,280,280,280,280,280,280
280,280,280,280,280,280,280,280,280,280,280,280,280,280,280,280,280,280,280,280,280,280,280,280,280,280,280,280,280,280,280,280,280,280,280,280,280,280,280,280,280,280,280,280,280,280,280,280,280,280,280,280,280,280,280,280,280,280,280,280,280,280,280,280,280,280,280,280,280,280,280,280,280,280,280,280,280,280,280,280
280,280,280,280,280,280,280,280,280,280,280,280,280,280,280,280,280,280,280,280,280,280,280,280,280,280,280,280,280,280,280,280,280,280,280,280,280,280,280,280,280,280,280,280,280,280,280,280,280,280,280,280,280,280,280,280,280,280,280,280,280,280,280,280,280,280,280,280,280,280,280,280,280,280,280,280,280,280,280,280
280,280,280,280,280,280,280,280,280,280,280,280,280,280,280,280,280,280,280,280,280,280,280,280,280,280,280,280,280,280,280,280,280,280,280,280,280,280,280,280,280,280,280,280,280,280,280,280,280,280,280,280,280,280,280,280,280,280,280,280,280,280,280,280,280,280,280,280,280,280,280,280,280,280,280,280,280,280,280,280
280,280,280,280,280,280,280,280,280,280,280,280,280,280,280,280,280,280,280,280,280,280,280,280,280,280,280,280,280,280,280,280,280,280,280,280,280,280,280,280,280,280,280,280,280,280,280,280,361,360,280,280,280,280,280,280,280,280,280,280,280,280,280,280,280,280,280,280,280,280,280,280,280,280,280,280,280,280,280,280
280,280,280,280,280,280,280,280,280,280,280,280,280,280,280,280,280,280,280,280,280,280,280,280,280,280,280,280,280,280,280,280,280,280,280,280,280,280,280,280,225,226,226,227,280,280,280,280,280,362,280,280,280,280,280,405,280,280,280,280,280,280,225,226,226,226,227,280,280,280,280,280,280,280,280,280,280,280,280,280
280,280,280,280,280,280,280,280,280,280,280,280,280,280,280,280,280,280,280,280,280,280,280,280,280,280,280,280,280,280,280,280,280,280,280,280,280,280,280,225,286,271,271,272,280,280,280,280,280,280,280,280,280,280,362,360,280,280,280,280,280,280,270,271,271,271,272,280,280,280,280,280,280,280,280,280,280,280,280,280
280,280,280,280,280,280,280,280,280,280,280,280,280,280,280,280,280,280,280,280,280,280,280,280,280,280,280,280,280,280,280,280,280,280,280,280,280,280,225,286,271,271,240,317,280,280,280,280,280,280,280,280,280,280,280,280,280,280,280,406,280,280,315,316,241,271,272,280,280,280,280,280,280,280,280,280,280,280,280,280
280,280,280,280,280,280,280,280,280,280,280,280,280,280,280,280,280,280,280,280,280,280,280,280,280,280,280,280,280,280,280,280,280,280,280,225,226,226,286,271,271,271,272,280,280,280,280,362,280,280,280,280,280,280,280,280,280,280,280,280,280,280,280,280,270,271,272,280,280,280,280,280,280,280,280,280,280,280,280,280
280,280,280,280,280,280,280,280,280,280,280,280,280,280,280,280,280,280,280,280,280,280,280,280,280,280,280,280,280,280,280,280,280,280,225,286,271,271,271,271,271,271,272,280,280,280,280,280,280,280,280,280,280,280,280,280,280,280,280,280,280,280,280,280,270,271,272,280,280,280,280,280,280,280,280,280,280,280,280,280
280,280,280,280,280,280,280,280,280,280,280,280,280,280,280,280,280,280,280,280,280,280,280,280,280,280,280,280,280,280,280,280,280,225,286,271,271,271,271,271,271,271,272,280,280,280,280,280,280,405,280,280,280,280,280,280,280,280,280,280,280,280,280,280,270,271,272,280,280,280,280,280,280,280,280,280,280,280,280,280
280,280,280,280,280,280,280,280,280,280,280,280,280,280,280,280,280,280,280,280,280,280,280,280,280,280,280,280,280,280,225,226,226,286,271,271,271,271,271,271,271,271,272,280,280,280,280,280,280,280,280,280,280,280,280,280,280,360,280,280,280,280,280,280,270,271,285,227,280,280,280,280,280,280,280,280,280,280,280,280
280,280,280,280,280,280,280,280,280,280,280,280,280,280,280,280,280,280,280,280,280,280,280,280,280,280,280,280,225,226,286,271,271,271,271,271,271,271,271,271,271,240,317,280,362,360,280,280,280,280,280,280,280,280,280,280,280,407,280,280,280,280,280,280,270,271,271,272,280,280,280,280,280,280,280,280,280,280,280,280
280,280,280,280,280,280,280,280,280,280,280,280,280,280,280,280,280,280,280,280,280,280,280,280,280,280,225,226,286,271,271,271,271,271,271,271,271,271,271,271,240,317,280,280,406,280,280,280,280,280,280,280,280,361,280,280,280,360,280,280,280,280,280,225,286,271,271,285,227,280,280,280,280,280,280,280,280,280,280,280
280,280,280,280,280,280,280,280,280,280,280,280,280,280,280,280,280,280,280,280,280,280,280,280,280,225,286,271,271,271,271,271,271,271,271,271,271,271,271,240,317,280,280,280,280,280,280,280,406,280,280,280,280,280,280,280,362,280,280,280,280,280,225,286,271,271,271,271,272,280,280,280,280,280,280,280,280,280,280,280
280,280,280,280,280,280,280,280,280,280,280,280,280,280,280,280,280,280,280,280,280,280,280,280,280,270,271,271,271,271,271,271,271,271,271,271,271,240,316,317,280,280,280,280,280,280,280,280,280,280,280,280,280,280,280,280,280,280,280,280,280,280,270,271,271,271,271,271,285,227,280,280,280,280,280,280,280,280,280,280
280,280,280,280,280,280,280,280,280,280,280,280,280,280,280,280,280,280,280,280,280,280,225,226,226,286,271,271,271,271,240,316,316,316,316,316,316,317,280,280,280,280,280,280,280,280,280,280,280,280,280,280,280,280,280,280,280,280,280,280,280,280,270,271,271,271,271,271,271,272,280,280,280,280,280,280,280,280,280,280
280,280,280,280,280,280,280,280,280,280,407,405,280,280,280,280,280,280,280,280,280,280,270,271,271,271,271,240,316,316,317,280,280,280,280,280,280,280,280,360,280,280,280,280,280,280,280,280,280,280,280,280,280,280,280,280,280,280,280,280,280,280,270,271,271,271,271,271,271,285,227,280,280,280,280,280,280,280,280,280
280,280,280,280,280,280,280,280,280,280,280,280,280,280,280,280,280,280,280,280,280,280,315,316,316,316,316,317,280,280,280,280,280,280,280,280,280,280,280,280,280,280,280,280,280,280,280,280,280,280,280,280,280,280,361,280,280,280,280,280,280,280,270,271,271,271,271,271,271,271,285,227,280,280,280,280,406,280,280,280
280,280,280,280,280,280,280,280,280,280,280,280,280,280,280,280,280,280,280,280,407,280,280,280,280,280,280,280,280,280,280,280,362,280,280,280,280,280,280,280,280,280,280,280,280,360,362,360,362,361,362,362,407,405,406,405,280,280,280,280,280,280,315,241,271,271,271,271,271,271,271,272,280,280,280,280,280,280,280,280
280,280,280,280,280,280,280,280,280,280,280,280,280,280,280,280,280,280,280,405,406,280,280,280,280,280,280,280,280,280,280,280,362,280,280,280,280,280,280,280,280,280,280,280,280,280,280,280,280,280,280,280,280,280,280,280,280,280,280,280,280,280,280,315,241,271,271,271,271,271,271,272,280,280,280,280,280,280,280,280
280,280,280,280,405,280,280,280,280,280,280,280,280,280,280,280,280,280,280,280,280,280,280,280,280,280,280,280,280,280,280,280,280,280,280,280,280,280,280,280,280,280,280,280,280,280,280,280,280,280,280,280,280,362,407,280,280,280,280,280,280,280,280,280,315,241,271,271,271,271,271,285,227,280,280,280,280,280,280,280
280,280,280,280,280,280,280,280,280,280,280,280,280,280,280,280,280,280,280,280,280,280,280,280,280,280,280,280,280,280,280,280,280,280,280,280,280,280,280,280,406,407,406,280,280,280,280,280,280,280,280,280,280,280,280,280,280,280,280,280,280,280,280,280,280,315,241,271,271,271,271,271,285,227,280,280,280,280,280,280
280,280,280,280,280,280,280,280,280,280,280,280,280,362,407,360,407,405,406,407,405,362,280,280,280,280,280,280,280,280,280,280,280,280,280,280,407,361,362,407,280,280,280,280,280,280,280,280,280,280,280,280,280,280,280,280,280,280,280,280,280,280,280,280,280,280,315,316,241,271,271,271,271,272,280,280,280,280,280,280
280,280,280,280,280,280,407,280,280,280,280,280,280,280,280,280,280,280,280,280,280,280,280,280,280,280,280,280,280,280,280,280,280,280,280,362,406,280,361,360,280,280,280,280,280,280,280,280,280,280,280,280,280,280,280,280,280,280,280,280,280,280,280,280,280,280,280,280,270,271,271,271,271,285,226,227,280,280,280,280
280,280,280,280,280,280,362,280,280,280,280,280,280,280,280,280,280,280,280,280,280,280,280,280,280,280,280,280,280,280,280,280,280,407,405,280,280,280,280,360,405,360,280,280,280,280,360,405,407,407,280,280,280,280,280,280,280,280,280,280,280,280,280,280,280,280,280,280,315,241,271,271,271,271,271,285,227,280,280,280
280,280,280,280,280,280,280,280,280,280,280,280,280,280,280,280,280,280,280,280,280,280,280,280,280,280,280,280,280,280,280,280,405,362,280,360,406,280,280,280,280,280,407,361,280,280,280,280,280,280,280,280,407,280,280,280,280,280,280,280,280,280,280,280,280,280,280,280,280,315,316,241,271,271,271,271,285,227,280,280
280,280,280,280,280,280,280,280,280,280,280,280,280,280,407,405,407,280,280,280,280,280,280,280,280,280,280,280,280,280,280,280,280,280,280,280,280,280,280,280,280,280,280,280,360,360,405,280,280,280,280,280,360,280,280,280,280,280,361,280,280,280,280,280,280,280,280,280,280,280,280,315,241,240,241,271,271,272,280,280
280,280,280,280,280,280,280,280,280,280,280,280,405,362,280,280,280,280,280,280,280,280,280,280,280,280,280,280,280,361,280,280,280,280,280,280,280,280,280,280,280,280,280,280,280,280,407,407,406,280,280,280,405,280,280,280,280,360,407,280,280,280,280,280,280,280,280,407,406,360,280,280,270,285,286,271,271,285,227,280
280,280,280,280,280,280,280,280,280,280,280,280,407,280,280,280,280,280,280,280,280,280,280,280,280,280,280,280,280,280,280,280,280,280,280,280,280,280,280,280,280,280,280,280,280,280,280,280,362,361,280,280,280,280,280,280,280,361,361,280,280,280,280,280,280,280,280,280,280,280,280,280,315,241,271,271,271,271,285,227
280,280,406,405,361,362,405,280,280,225,226,226,226,227,280,280,280,280,280,280,280,280,280,280,280,280,280,280,280,280,280,280,280,280,280,280,280,280,280,280,280,280,280,280,280,405,280,280,280,280,280,280,405,361,407,406,406,360,407,361,280,280,280,280,280,405,361,280,280,280,280,280,280,315,241,271,271,271,271,285
280,362,280,280,280,280,280,225,226,286,271,271,271,285,226,227,280,280,280,280,280,280,280,407,405,280,280,280,280,280,280,280,280,280,280,280,280,280,280,280,280,280,280,280,280,406,280,280,280,280,280,280,407,280,280,280,280,280,362,406,280,280,280,280,280,361,280,280,280,280,280,280,280,280,315,241,271,271,271,271
280,280,280,280,280,280,225,286,271,271,271,271,271,271,271,285,226,227,280,280,280,280,280,280,280,280,280,280,280,280,280,280,280,280,280,280,280,280,280,280,280,280,280,280,280,280,280,280,280,280,280,280,280,280,280,280,280,280,280,280,280,280,280,280,280,280,280,280,280,280,280,280,280,280,361,315,241,271,271,271
280,280,280,225,226,226,286,271,271,240,241,271,271,240,316,241,271,285,226,227,280,280,280,280,280,280,280,280,280,280,280,280,280,280,280,280,280,280,280,280,280,280,280,280,280,362,406,280,280,280,280,280,280,280,280,280,280,280,280,280,280,280,280,280,280,280,280,280,280,280,280,280,280,280,360,280,315,241,271,271
225,226,226,286,271,271,271,271,271,285,286,271,271,285,226,286,271,271,271,285,226,226,227,405,280,280,280,280,225,226,226,226,226,226,226,226,226,226,226,226,226,226,227,280,280,362,362,280,280,280,280,280,280,280,280,280,361,280,280,280,280,407,361,361,407,280,280,280,280,280,280,280,280,280,405,280,280,315,241,271
286,271,271,271,271,271,271,271,271,271,271,271,271,271,271,271,271,271,271,271,271,271,285,226,226,226,226,226,286,271,271,271,271,271,271,271,271,271,271,271,271,271,285,226,227,280,280,280,405,360,280,280,280,280,280,280,280,280,280,280,280,280,280,280,280,280,280,280,280,280,280,280,280,280,362,280,280,280,270,271
271,271,271,271,271,271,271,271,271,271,271,271,271,271,271,271,271,271,271,271,271,271,271,271,271,271,271,271,410,271,271,271,271,271,363,271,271,271,271,408,363,364,409,364,285,226,227,280,362,405,280,280,280,280,280,280,280,280,280,280,280,280,280,280,280,280,280,280,280,280,280,280,280,280,360,280,280,280,270,271
271,271,271,271,271,271,271,271,271,271,271,271,271,271,271,271,271,271,271,271,271,271,271,271,271,271,271,271,271,271,271,271,271,271,271,271,271,271,271,271,271,271,271,271,271,271,272,280,407,280,280,280,280,280,361,280,280,280,280,280,280,280,280,280,280,280,280,280,280,362,280,280,280,280,360,280,280,280,315,241
271,271,271,271,271,271,271,271,240,241,271,271,240,241,271,271,271,271,271,271,271,271,271,408,271,271,271,271,271,271,271,271,271,271,271,271,271,271,271,271,271,271,271,271,271,271,285,227,280,280,280,280,280,280,280,280,361,280,280,280,280,362,406,280,280,280,280,405,280,360,280,280,280,280,361,280,280,280,405,315
271,271,271,271,271,271,271,271,285,286,271,271,285,286,271,271,271,271,271,271,271,271,271,271,271,271,271,271,271,271,271,271,271,271,271,271,271,271,271,271,271,271,271,271,271,271,271,285,226,227,280,280,280,280,280,280,406,280,280,280,280,280,405,280,280,280,280,280,280,406,280,280,280,280,280,280,280,280,280,406
271,271,271,271,271,271,271,271,271,271,271,271,271,271,271,240,316,241,271,271,271,271,271,271,271,271,271,271,271,271,271,271,271,271,271,271,271,271,271,271,271,271,271,271,271,271,271,271,271,285,227,280,280,280,280,280,280,280,280,280,280,280,280,280,280,280,407,280,280,280,362,280,280,280,280,280,280,280,280,406
271,271,271,271,271,271,271,271,271,271,271,271,271,271,271,285,226,286,271,271,271,271,271,271,271,271,271,271,271,271,271,271,271,271,271,271,271,240,241,271,271,271,271,271,271,271,271,271,271,271,285,227,280,280,280,362,405,280,280,280,280,280,280,280,280,280,407,280,280,280,361,360,280,280,280,280,280,280,280,280
271,271,271,271,271,271,271,271,271,271,271,271,271,271,271,271,271,271,271,271,271,271,271,271,271,271,271,271,271,271,271,271,271,271,271,271,271,285,286,271,271,271,271,271,271,271,271,271,271,271,271,272,280,280,280,280,360,280,280,280,280,280,280,280,280,280,407,407,280,280,280,362,280,280,280,280,280,280,280,280
271,271,271,271,271,271,271,271,271,271,271,271,271,271,271,271,271,271,271,271,271,271,271,271,271,271,271,271,271,271,271,271,271,271,271,271,271,271,271,271,271,271,271,271,271,271,271,271,271,271,271,285,227,280,280,280,280,280,280,280,280,280,280,280,280,280,280,280,280,280,280,362,280,280,280,280,280,280,280,280
271,271,271,271,271,271,271,271,271,271,271,271,271,271,271,271,271,271,271,271,271,271,271,271,271,271,271,271,271,271,271,271,271,271,271,271,271,271,271,271,271,271,271,271,271,271,271,271,271,271,271,271,285,227,280,280,280,280,280,280,280,280,280,280,280,280,280,280,280,280,362,406,280,280,280,361,280,280,280,280
271,271,271,271,271,271,271,271,271,271,271,271,271,271,271,271,271,271,271,271,271,271,271,271,271,271,271,271,271,271,271,271,271,271,271,271,271,271,271,271,271,271,271,271,271,271,271,271,271,271,271,271,271,285,227,280,280,280,280,280,280,280,280,280,280,280,280,280,280,280,280,361,360,280,280,280,280,280,280,280
271,271,271,271,271,271,271,271,271,271,271,271,271,271,271,271,271,271,271,271,271,271,271,271,271,271,271,271,271,271,271,271,271,271,271,271,271,271,271,271,271,271,271,271,271,271,271,271,271,271,271,271,271,271,285,227,280,280,280,280,280,280,280,280,280,280,406,360,280,280,280,280,280,280,280,280,280,280,280,280
271,271,271,271,271,271,271,271,271,271,271,271,271,271,271,271,271,271,271,271,271,271,271,271,271,271,271,271,271,271,271,271,271,271,271,271,271,240,316,241,271,271,271,271,271,271,271,271,271,271,271,271,271,271,271,285,227,280,280,280,280,280,280,280,280,280,280,280,280,280,280,280,280,280,280,280,280,280,280,280
271,271,271,271,271,271,271,271,271,271,271,271,271,271,271,271,271,271,271,271,271,271,271,271,271,271,271,271,271,271,271,271,271,271,271,271,271,285,226,286,271,271,271,240,316,316,241,271,271,271,271,271,271,271,271,271,285,227,280,280,280,280,280,280,280,280,280,280,280,280,280,280,280,280,280,280,280,280,280,280
271,271,271,271,271,271,271,271,271,271,271,271,271,271,271,271,271,271,271,271,271,271,271,271,271,271,271,271,271,271,271,271,271,271,271,271,271,271,271,271,271,271,271,285,226,226,286,271,271,271,271,271,271,271,271,271,271,285,227,225,226,227,280,280,280,280,280,280,280,280,280,280,280,361,280,280,407,280,280,280
271,271,271,271,271,271,271,271,271,271,271,271,271,271,271,271,271,271,271,271,271,271,271,271,271,271,271,271,271,271,271,271,271,271,271,271,271,271,271,271,271,271,271,271,271,271,271,271,271,271,271,271,271,271,271,271,271,271,285,286,271,285,226,227,280,280,280,280,280,280,280,280,280,405,405,280,406,360,280,280
271,271,271,271,271,271,271,271,271,271,271,271,271,271,271,271,271,271,271,271,271,271,271,271,271,271,271,271,271,271,271,271,271,271,271,271,271,271,271,271,271,271,271,271,271,271,271,271,271,271,271,271,271,271,271,271,271,240,241,271,271,271,271,285,227,280,280,280,280,280,361,280,280,280,280,280,280,280,361,405
271,271,271,271,271,271,271,271,271,271,271,271,271,271,271,271,271,271,271,271,271,271,271,271,271,271,271,271,271,271,271,271,271,271,240,241,271,271,271,271,271,271,271,271,271,271,271,271,271,271,271,271,271,271,271,271,271,272,270,271,271,271,271,271,285,227,280,280,280,280,360,280,280,280,280,280,280,280,280,280
271,240,241,271,271,271,271,271,271,271,271,271,271,271,271,271,271,271,271,271,271,271,271,271,271,271,271,271,271,271,271,271,271,271,285,286,271,271,271,271,271,271,271,271,271,271,271,271,271,271,271,271,271,271,271,271,271,285,286,271,271,271,271,271,271,272,280,280,280,280,280,280,280,280,280,280,280,280,280,280
271,285,286,271,271,271,271,271,271,271,271,271,271,271,271,271,240,241,271,271,271,271,271,271,271,271,271,271,271,271,271,271,271,271,271,271,271,271,271,271,271,271,271,271,240,241,271,271,271,271,271,271,271,271,271,271,271,271,271,271,271,271,271,271,271,285,227,280,280,280,280,280,280,280,280,280,280,280,280,280
271,271,271,240,316,316,316,316,316,316,316,316,316,241,271,271,272,315,316,316,241,271,271,271,271,271,271,271,271,271,271,271,271,271,271,271,271,271,271,271,271,271,271,271,285,286,271,271,271,271,271,271,271,271,271,271,271,271,271,271,240,241,271,365,271,271,285,227,280,280,280,280,280,280,280,280,280,280,280,280
316,316,316,317,280,280,280,280,280,280,280,280,280,315,316,241,285,226,226,226,286,271,409,271,271,271,271,271,271,271,271,271,271,271,271,271,271,271,271,271,271,271,271,271,271,271,271,271,271,271,271,271,271,271,240,316,241,271,271,271,272,270,271,364,271,271,271,285,227,280,280,280,280,280,280,280,280,280,280,280
280,280,280,280,280,280,280,280,280,280,280,280,280,280,280,315,241,271,271,271,271,271,271,408,271,271,271,271,271,271,271,271,271,271,271,271,271,271,271,271,271,271,271,271,271,271,271,271,271,271,271,271,271,271,285,226,286,271,271,271,285,286,271,271,271,365,271,271,285,227,280,280,280,280,280,280,280,280,280,280
280,280,280,280,280,280,280,280,280,280,280,280,280,280,280,280,315,316,316,316,316,316,316,241,271,271,271,271,271,271,271,271,271,271,271,271,271,271,271,271,271,271,271,271,271,271,271,271,271,271,271,271,271,271,271,271,271,271,271,271,271,271,271,271,271,271,408,271,271,272,280,280,280,280,280,280,280,280,280,280
280,280,280,280,280,280,280,280,280,280,280,406,280,280,280,280,280,280,280,280,280,360,360,315,316,241,271,271,271,271,271,410,271,271,271,271,271,271,271,271,271,409,409,271,271,271,271,271,271,271,271,271,271,271,271,271,271,271,271,271,271,271,271,271,271,271,271,410,271,285,227,280,280,280,360,280,280,280,280,280
280,280,280,280,280,280,280,280,280,280,280,407,280,280,280,280,280,280,280,280,280,280,280,280,280,315,316,316,316,316,316,316,241,271,271,240,316,316,241,271,271,271,271,271,271,271,271,271,240,316,316,241,271,271,271,271,271,271,271,271,271,271,271,271,271,271,271,364,410,271,285,227,280,280,362,280,280,280,280,280
280,280,280,280,280,280,361,280,280,280,280,280,280,280,280,280,280,280,280,280,280,280,280,280,280,280,280,280,280,280,280,280,315,241,271,285,226,226,286,271,271,271,271,271,271,271,271,271,285,226,226,286,271,271,271,271,271,271,271,271,271,271,271,271,271,271,271,271,271,271,271,285,227,280,280,280,280,280,280,280
280,280,280,280,280,280,280,280,280,280,280,362,280,280,280,280,280,280,280,280,280,280,280,280,280,280,280,280,280,280,280,280,280,315,241,271,271,271,271,271,271,271,271,271,271,271,271,363,271,271,271,271,271,271,271,271,271,271,271,271,271,271,271,271,271,271,271,271,271,271,271,271,285,227,280,280,280,406,280,280
280,280,280,280,280,280,280,280,280,280,280,405,405,280,280,280,280,280,280,280,280,280,280,280,280,280,280,280,280,280,280,280,280,280,315,316,316,316,316,316,241,271,271,271,271,271,271,409,409,271,271,271,271,271,271,271,271,271,271,271,271,271,271,271,271,271,271,271,271,271,410,271,271,272,280,280,280,280,280,280
280,280,280,280,280,280,280,280,280,280,280,280,362,362,361,280,280,280,280,280,280,280,280,280,280,280,280,280,280,280,280,280,280,280,280,280,280,280,280,280,315,316,241,271,271,271,271,271,363,271,271,271,271,271,271,271,271,271,271,271,271,271,271,271,271,271,271,271,271,271,240,241,271,272,280,280,280,280,280,280
280,280,280,280,280,280,280,225,226,226,227,280,280,280,405,405,405,280,280,280,280,280,280,405,406,280,280,280,280,280,280,280,280,280,280,280,280,280,280,280,280,280,315,316,316,241,271,271,271,365,408,271,271,271,271,271,271,271,271,271,271,271,271,271,271,271,271,271,271,271,272,270,271,272,280,280,280,280,280,280
280,280,280,280,280,225,226,286,271,271,285,226,226,226,226,227,280,280,280,280,280,280,280,280,280,362,405,407,361,280,280,280,280,280,280,280,362,407,280,280,280,280,280,280,280,315,316,241,271,271,271,271,271,271,271,364,363,271,271,271,271,271,271,271,271,271,363,271,271,271,285,286,271,272,280,280,280,280,280,280
280,280,280,225,226,286,271,271,271,271,271,271,271,271,271,285,226,227,280,280,280,280,280,280,280,280,280,280,280,280,280,280,280,280,280,280,280,406,405,280,280,280,280,280,280,280,280,315,316,316,241,271,271,271,271,271,271,271,271,271,240,241,271,271,240,241,271,271,271,271,271,240,316,317,280,280,280,280,360,280
280,225,226,286,271,271,271,271,271,271,271,271,271,271,271,271,271,285,227,280,280,280,280,280,280,280,280,280,280,280,280,280,280,280,280,280,280,280,362,362,280,280,280,280,280,280,280,280,280,280,315,316,316,316,241,271,271,271,271,271,285,286,271,271,285,286,271,271,271,240,316,317,280,280,280,280,280,280,280,280
225,286,271,271,271,271,271,271,271,271,271,271,271,271,271,271,271,271,285,226,226,226,227,280,280,280,280,280,280,280,280,280,280,407,406,280,280,280,280,280,407,406,280,280,280,280,280,280,280,280,280,280,280,280,315,316,316,241,271,271,271,271,271,271,271,271,271,240,316,317,280,280,280,280,280,280,280,280,280,280
286,271,271,271,271,271,271,271,240,316,316,241,271,271,271,271,271,271,271,271,271,271,285,226,226,226,226,226,227,280,280,280,280,280,361,361,406,280,280,280,280,280,405,280,280,280,280,280,280,280,280,280,280,280,280,280,280,315,316,316,241,271,271,271,271,240,316,317,280,280,280,280,280,280,280,280,280,280,280,280
271,271,271,240,241,271,271,240,317,225,226,286,271,271,271,271,271,240,241,271,271,271,271,271,271,271,271,271,285,226,227,280,280,280,280,280,280,406,361,280,280,280,280,280,280,280,280,280,280,280,280,280,280,280,280,280,280,280,280,280,270,271,271,271,271,272,280,280,280,280,280,280,280,280,280,280,280,280,280,280
271,271,271,285,286,271,271,285,226,286,271,271,271,271,271,271,271,285,286,271,271,271,271,271,271,271,271,271,271,271,285,226,227,280,280,280,280,280,280,280,280,280,280,280,280,280,280,280,280,280,280,280,280,280,280,280,280,280,280,280,315,316,316,316,316,317,280,280,280,280,280,280,280,280,362,362,280,280,280,280
271,271,271,271,271,271,271,271,271,271,271,271,271,271,271,271,240,241,271,271,271,240,241,271,271,271,271,271,271,271,271,271,285,227,280,280,280,280,280,280,280,280,280,280,280,280,280,280,280,280,280,280,280,280,280,280,280,280,405,280,280,280,280,280,280,280,280,280,280,280,280,280,280,280,280,280,280,280,280,280
271,271,271,271,271,271,271,271,271,271,271,271,271,271,271,271,285,286,271,271,271,272,315,316,316,241,271,271,271,271,271,271,271,285,227,280,280,280,280,280,280,280,280,280,280,280,280,280,280,280,280,406,361,280,280,406,361,280,280,280,280,280,280,280,280,280,280,280,280,280,280,280,280,280,280,280,280,280,280,280
271,271,271,271,271,271,271,271,271,271,271,271,271,271,271,271,271,271,271,271,271,285,226,226,226,286,271,271,409,271,271,271,271,271,285,226,227,280,280,280,280,280,280,280,280,280,280,280,280,280,280,280,280,280,280,280,362,361,280,280,280,280,280,280,280,280,280,280,360,280,280,280,280,280,280,280,280,280,280,280
