280,280,280,280,280,280,280,280,280,280,280,280,280,280,280,280,270,271,271,271,271,271,271,271,271,271,271,271,271,271,271,271,271,271,271,271,271,272,280,280,280,280,280,280,280,280,280,315,316,241,271,285,226,227,280,361,280,280,280,280,280,280,280,280,280,280,280,280,280,280,280,280,280,280,407,280,280,280,280,280
280,280,280,280,280,280,280,280,280,280,405,280,280,280,280,280,270,271,271,271,271,271,271,271,271,271,271,271,271,271,271,271,271,271,271,271,271,272,280,280,280,280,280,280,280,280,280,280,225,286,271,271,271,272,360,361,280,280,280,280,280,280,280,280,280,280,280,280,280,280,280,280,280,280,406,280,280,280,280,280
280,280,280,280,280,280,280,280,280,280,361,280,280,280,280,225,286,271,271,271,271,271,271,271,271,271,271,271,271,271,271,271,271,271,271,271,271,272,280,280,280,280,280,280,280,280,280,280,270,271,271,271,271,272,407,280,280,280,280,280,280,280,280,280,280,280,280,280,280,280,280,280,280,407,406,280,280,280,280,280
280,280,280,280,280,280,280,280,280,280,361,280,280,280,280,270,271,271,271,271,271,271,271,271,271,271,271,271,271,271,271,271,271,271,271,271,271,272,280,280,280,280,280,280,280,280,280,225,286,271,271,271,271,272,280,280,280,280,280,280,280,280,280,280,280,280,280,280,280,280,280,280,280,405,280,280,280,280,280,280
280,280,280,280,280,280,280,280,280,280,362,280,280,280,225,286,271,271,271,271,271,271,271,271,271,271,271,271,271,271,271,271,271,271,271,271,271,272,280,280,280,280,280,280,280,280,280,270,271,271,271,271,240,317,280,280,280,280,280,280,280,280,280,280,280,280,280,280,280,280,280,280,280,280,280,280,280,280,280,280
280,280,280,280,280,280,280,280,280,280,280,280,280,225,286,271,271,271,271,240,241,271,271,271,271,271,271,271,271,271,271,271,271,271,271,271,271,272,280,280,280,280,280,280,280,280,225,286,271,271,271,271,272,280,280,280,280,280,280,280,280,280,280,280,280,280,280,280,280,280,280,280,280,280,280,280,280,280,280,280
280,280,280,280,280,280,280,280,280,280,280,280,280,270,271,271,271,271,271,272,270,271,271,271,271,271,271,271,271,271,271,271,271,271,240,241,271,272,280,280,280,280,280,280,280,280,270,271,271,271,271,271,272,280,280,280,280,280,280,280,280,280,280,280,280,280,280,280,280,280,280,280,280,280,280,280,280,280,280,280
280,280,280,280,280,280,280,280,280,280,280,280,280,270,271,271,271,271,271,285,286,271,271,271,271,271,271,271,271,271,271,271,271,271,285,286,271,272,280,280,280,280,280,280,280,280,315,241,271,271,271,271,272,280,280,360,405,280,280,280,280,280,280,280,280,280,280,280,280,280,280,280,280,280,280,280,280,280,280,280
280,280,280,280,280,280,362,280,280,280,280,280,225,286,271,271,271,271,271,271,271,271,271,271,271,271,271,271,271,271,271,271,271,240,241,271,271,272,280,280,280,280,280,280,280,280,280,270,271,271,271,240,317,280,280,280,280,407,407,406,280,280,361,280,280,280,280,280,280,280,280,280,280,280,280,280,280,280,280,280
280,280,280,280,280,280,280,280,280,280,280,225,286,271,271,271,271,271,271,271,271,271,271,271,271,271,271,271,271,271,271,271,271,272,270,271,271,272,280,280,280,280,280,280,280,280,280,315,241,271,271,272,280,280,280,280,280,280,280,361,280,280,280,280,280,280,280,360,280,280,280,280,280,280,280,280,280,280,280,280
280,280,280,280,280,280,280,280,280,360,225,286,271,271,271,271,271,271,271,271,271,271,271,271,271,271,271,271,271,271,271,271,271,285,286,271,271,272,280,280,280,280,280,280,280,280,280,280,315,316,316,317,280,280,280,280,280,280,280,362,280,280,280,280,280,280,280,280,406,362,406,407,280,280,280,280,280,280,280,280
280,280,280,280,280,280,280,280,280,280,270,271,271,271,271,271,271,271,271,271,271,271,271,271,271,271,271,271,271,271,271,271,271,271,271,271,271,272,280,280,280,280,280,280,280,280,280,280,280,280,280,280,280,280,280,280,280,280,406,280,280,280,280,280,280,280,280,280,280,280,280,280,280,280,362,280,280,280,280,280
280,280,280,405,280,280,280,280,280,225,286,271,271,271,271,271,271,271,271,271,271,271,271,271,271,271,271,271,271,271,271,271,271,271,271,271,271,272,280,280,280,280,280,280,280,280,280,280,280,280,280,280,280,280,280,280,280,406,407,280,280,280,280,280,280,280,280,280,280,280,280,280,280,406,406,280,280,280,280,280
280,280,280,360,280,280,280,280,225,286,271,271,271,271,271,271,271,271,271,271,271,271,271,271,271,271,271,271,271,271,271,271,271,271,271,271,240,317,280,280,280,280,280,280,280,280,280,280,280,280,280,280,280,280,280,280,361,406,280,280,280,280,280,280,280,280,280,280,280,280,280,280,280,280,280,280,280,280,280,280
280,280,280,360,280,280,280,360,270,271,271,271,271,271,271,271,271,271,271,271,271,271,271,271,271,271,271,271,271,271,271,271,271,271,271,271,272,280,360,405,280,280,280,280,280,280,280,280,280,280,280,280,280,280,280,280,280,280,280,280,280,280,280,280,280,280,280,280,280,280,280,280,280,280,280,280,280,280,280,280
280,280,280,280,280,280,280,225,286,271,271,271,271,271,271,271,271,271,271,271,271,271,271,271,271,271,271,271,271,271,271,240,241,271,271,271,272,280,280,362,280,280,280,280,280,280,280,280,280,280,280,280,407,280,280,280,280,280,280,280,280,280,280,280,280,280,280,280,280,280,280,280,280,280,280,280,280,280,280,280
280,280,280,280,280,280,225,286,271,271,271,271,271,271,271,271,271,271,271,271,271,271,271,271,271,271,271,271,271,271,271,285,286,271,271,240,317,280,280,280,280,280,280,280,280,280,280,280,280,280,280,280,405,280,280,280,280,280,280,280,280,280,280,280,280,280,280,280,280,280,280,280,280,280,280,280,280,280,280,280
280,280,280,280,280,280,270,271,271,271,271,271,271,271,271,271,271,271,271,271,271,271,271,271,271,271,271,271,271,271,271,271,271,271,271,272,280,280,280,280,280,280,280,280,280,280,280,280,280,280,280,280,280,280,280,280,280,280,280,361,280,280,280,280,280,280,280,280,280,280,280,280,280,280,280,280,280,280,280,280
280,280,407,360,280,225,286,271,271,271,271,271,271,271,271,271,271,271,271,271,271,271,271,271,271,271,271,271,271,271,271,271,271,271,240,317,280,280,280,280,280,280,280,280,280,280,280,280,280,280,280,280,280,280,280,280,280,280,280,280,280,280,280,280,225,226,227,280,280,280,280,280,280,280,280,280,280,280,280,280
280,280,361,280,280,270,271,271,271,271,271,271,271,271,271,271,271,271,271,271,271,271,271,271,271,271,271,271,271,271,271,271,271,271,272,280,280,280,280,280,280,280,362,280,280,280,280,280,280,280,280,280,280,280,280,280,280,280,280,280,280,280,280,280,270,271,272,280,280,280,280,280,280,280,280,280,280,280,280,280
280,280,407,280,225,286,271,271,271,271,271,271,271,271,271,271,271,271,271,271,271,271,271,271,271,271,271,271,271,271,271,271,271,240,317,280,280,280,280,280,280,280,280,280,280,280,280,280,280,280,280,280,280,280,280,280,280,280,280,280,280,280,225,226,286,271,285,227,280,280,280,280,280,280,280,280,280,280,280,280
280,280,280,225,286,271,271,271,271,271,271,271,271,271,271,271,271,271,271,271,271,271,271,271,271,271,271,271,240,241,271,271,240,317,280,280,280,280,280,280,280,280,280,280,280,280,280,280,280,280,280,280,280,280,280,280,280,280,280,280,280,280,270,271,271,271,271,272,280,280,280,280,280,280,280,280,280,280,280,280
280,280,225,286,271,271,271,271,271,271,271,271,271,271,271,271,271,271,271,271,271,271,271,271,271,271,271,271,285,286,271,240,317,280,280,280,280,280,280,280,280,280,280,280,280,280,280,280,280,280,280,280,280,280,280,280,280,280,280,280,280,280,270,271,271,271,271,272,280,280,280,280,280,280,280,280,280,280,280,280
280,225,286,271,271,271,271,271,271,271,271,271,271,271,271,271,271,271,271,271,271,271,271,271,271,271,271,271,271,271,271,272,280,280,280,280,280,280,280,406,280,280,280,280,280,280,280,280,280,280,407,280,280,280,280,280,280,280,280,280,280,280,270,271,271,271,271,272,280,280,280,280,280,280,280,280,280,280,280,280
225,286,271,271,271,271,271,271,271,271,271,271,271,271,271,271,271,271,271,271,271,271,271,271,271,271,271,271,271,271,240,317,280,280,280,280,280,280,280,280,280,280,280,225,226,226,227,280,280,280,280,280,280,280,280,280,280,280,280,280,280,225,286,271,271,271,240,317,280,280,280,280,280,280,280,280,280,280,280,280
286,271,271,271,271,271,271,271,271,271,271,271,271,271,271,271,271,271,271,271,271,271,271,271,271,271,271,271,271,240,317,280,280,280,280,280,280,280,280,280,280,280,280,270,271,271,272,280,280,280,280,280,280,280,280,280,280,280,280,280,280,270,271,271,271,240,317,280,280,280,280,280,280,280,280,280,280,280,280,280
271,271,271,271,271,271,271,271,271,271,271,271,271,271,271,271,271,271,271,271,271,271,271,271,271,271,271,271,271,272,280,280,280,280,280,280,280,280,280,280,280,225,226,286,271,271,272,280,280,280,280,360,362,280,280,280,280,280,280,280,280,270,271,271,240,317,280,280,280,280,280,280,280,280,280,280,280,280,280,280
271,271,271,271,271,271,271,271,271,271,271,271,271,271,271,271,271,271,271,271,271,271,271,271,271,271,271,271,240,317,280,280,280,280,280,280,280,280,280,280,225,286,271,271,271,240,317,280,280,280,280,280,280,280,280,280,280,280,280,280,225,286,271,271,285,226,227,280,280,280,280,280,280,280,280,280,280,280,280,280
271,271,271,271,271,271,271,271,271,271,271,271,271,271,271,271,271,271,271,271,271,271,271,271,271,271,271,240,317,280,280,280,280,280,280,405,280,280,280,280,270,271,271,240,316,317,280,280,280,280,280,280,280,280,280,280,280,280,225,226,286,271,271,271,271,271,272,280,280,280,280,280,280,280,280,280,280,280,280,280
271,271,271,271,271,271,271,271,271,271,271,271,271,271,271,271,271,271,271,271,271,271,271,271,271,271,240,317,280,280,280,280,280,280,280,407,280,280,280,225,286,271,271,272,280,280,280,280,280,280,280,280,280,280,280,280,280,280,270,271,271,271,271,271,271,271,272,280,280,280,280,280,280,280,280,280,280,280,280,280
271,271,271,271,271,271,271,271,271,271,271,271,271,271,271,271,271,271,271,271,271,271,271,271,271,271,272,280,280,280,280,280,280,280,280,280,280,280,225,286,271,271,271,272,280,280,280,280,280,280,280,280,280,280,280,280,280,280,270,271,271,271,271,271,271,271,272,280,280,280,280,280,280,280,280,280,280,280,280,280
271,271,271,271,271,271,271,271,271,271,271,271,271,271,271,271,271,271,271,271,271,271,271,271,271,240,317,280,280,280,280,280,280,280,280,225,226,226,286,271,271,271,271,272,280,280,280,280,280,280,280,280,280,280,280,280,280,225,286,271,271,271,271,271,271,240,317,280,280,280,280,280,280,280,280,280,280,280,280,280
271,271,271,271,271,271,271,271,271,271,271,271,271,271,271,271,271,271,271,271,271,271,271,271,271,272,280,280,280,280,280,280,280,280,280,270,271,271,271,271,271,271,271,272,280,280,280,280,280,280,280,280,280,280,280,280,225,286,271,271,271,271,271,271,240,317,280,280,280,280,280,280,280,280,280,280,280,280,280,280
271,271,271,271,271,271,271,271,271,271,271,271,271,271,271,271,271,271,271,271,271,271,271,271,240,317,280,280,280,280,280,280,280,280,280,270,271,271,240,241,271,271,240,317,280,280,280,280,280,280,280,280,280,280,280,280,270,271,271,271,271,271,271,271,272,280,280,280,280,280,280,280,280,280,280,280,280,280,280,280
271,271,271,271,271,271,271,271,271,271,271,271,271,271,271,271,271,271,271,271,271,271,271,240,317,280,280,280,280,280,280,280,280,280,225,286,271,271,285,286,271,271,272,280,280,280,280,280,280,280,280,280,280,280,407,280,270,271,271,271,271,271,271,271,272,280,280,280,280,280,280,280,280,280,280,280,280,280,280,280
271,271,271,271,271,271,271,271,271,271,271,271,271,271,271,271,271,271,271,271,271,271,240,317,280,280,280,280,280,280,280,280,280,280,270,271,271,271,271,271,271,240,317,280,280,280,280,280,280,280,280,280,280,280,280,280,270,271,271,271,271,271,271,240,317,280,280,280,280,280,280,280,280,280,280,280,280,280,280,280
271,271,271,271,271,271,271,271,271,271,271,271,271,271,271,271,271,271,271,271,271,240,317,280,280,280,280,280,280,280,280,280,280,225,286,271,271,271,271,271,240,317,280,280,280,280,280,280,280,280,280,280,280,280,280,280,270,271,271,271,271,271,271,272,280,280,280,280,280,280,280,280,280,280,280,280,280,280,280,280
271,271,271,271,271,271,271,271,271,271,271,271,271,271,271,271,271,271,271,240,316,317,280,280,280,280,280,280,280,280,280,280,225,286,271,271,271,271,271,240,317,280,280,280,280,280,280,280,280,280,280,280,280,280,280,280,315,241,271,271,271,271,271,272,280,280,280,280,280,280,280,280,280,280,280,280,280,280,280,280
271,271,271,271,271,271,271,271,271,271,271,271,271,271,271,271,271,271,240,317,280,280,280,280,280,280,280,280,280,280,280,225,286,271,271,271,271,271,240,317,280,280,280,280,280,280,280,280,280,280,280,280,280,280,280,280,360,270,271,271,271,271,271,272,280,280,280,280,280,280,280,280,280,280,280,280,280,280,280,280
271,271,271,271,271,271,271,271,271,271,271,271,271,271,271,271,271,240,317,280,280,280,280,280,280,280,280,280,280,280,280,270,271,271,271,271,271,271,272,280,280,280,280,280,280,280,280,280,280,280,280,280,280,280,362,405,280,270,271,271,271,240,316,317,280,280,280,280,280,280,280,280,280,280,280,280,280,280,280,280
271,271,271,271,271,271,271,271,271,271,271,271,271,271,271,240,316,317,280,280,280,280,280,280,280,280,280,280,280,225,226,286,271,271,271,271,271,240,317,280,280,280,280,280,280,280,280,280,280,280,280,280,406,361,280,280,280,315,316,316,316,317,280,280,280,280,280,280,280,280,280,280,280,280,280,280,280,280,280,280
271,271,271,271,271,271,271,271,271,271,271,271,240,241,271,272,280,280,280,280,280,280,280,280,280,362,280,280,280,270,271,271,271,271,271,271,271,285,226,227,280,280,280,280,280,280,280,280,280,280,280,280,280,280,280,280,280,280,280,280,280,280,280,280,280,280,280,280,280,280,280,280,280,280,280,280,280,280,280,280
271,271,271,271,271,271,240,316,316,316,241,271,285,286,240,317,280,280,280,280,280,280,280,280,406,280,280,280,280,270,271,271,271,271,271,240,316,241,271,272,280,280,280,280,406,280,280,280,280,280,280,280,280,280,280,280,280,280,280,280,280,280,360,280,280,280,280,280,280,280,280,280,280,280,280,280,280,280,280,280
271,271,271,271,240,316,317,225,226,226,286,271,271,240,317,280,280,280,280,280,280,280,280,280,280,280,280,280,280,315,241,271,271,271,240,317,280,315,316,317,280,362,280,280,360,360,361,280,280,280,280,280,280,280,280,280,280,280,280,280,280,280,360,280,280,280,280,280,280,280,280,280,280,280,280,280,280,280,280,280
271,271,271,271,285,226,226,286,271,271,271,271,240,317,280,280,280,280,280,280,280,280,280,280,280,280,280,280,280,280,315,316,316,316,317,280,280,280,280,280,280,405,280,280,280,280,280,280,280,280,280,280,280,360,280,280,280,280,280,280,280,280,360,280,280,280,280,280,280,280,280,280,280,280,280,280,280,280,280,280
271,271,271,271,271,271,271,271,271,271,271,240,317,280,280,280,280,280,280,280,280,280,280,280,280,280,280,280,280,280,280,280,280,280,280,280,280,280,280,280,280,362,280,280,280,280,280,280,280,280,280,280,361,407,280,280,280,280,280,280,280,280,280,280,280,280,280,280,280,280,280,280,280,280,280,280,280,280,280,280
271,271,271,271,240,316,316,241,271,271,240,317,280,280,280,280,280,280,280,280,280,280,280,280,280,280,280,280,280,280,280,280,280,280,280,280,280,280,280,280,280,280,280,280,280,280,280,280,280,406,407,406,280,280,280,280,280,280,280,280,280,280,280,280,280,280,280,280,280,280,280,280,280,280,280,280,280,280,280,280
271,271,240,316,317,225,226,286,271,240,317,280,280,280,280,280,280,280,280,280,280,280,280,280,280,280,280,280,407,280,280,280,280,280,280,280,280,280,280,280,280,280,280,280,280,280,360,405,407,280,280,280,280,280,280,280,280,280,280,280,280,280,280,280,280,280,280,280,280,280,280,280,280,280,280,280,280,280,280,280
271,271,285,226,226,286,271,271,240,317,280,280,280,280,280,280,280,280,280,280,280,280,280,280,280,280,280,280,280,280,280,280,280,280,280,280,280,280,280,280,280,280,280,280,280,280,407,362,280,280,280,280,280,280,280,280,406,280,280,280,280,280,280,280,280,280,280,280,280,280,280,280,280,280,280,280,280,280,280,280
271,271,271,271,271,271,240,316,317,280,280,280,280,280,280,280,280,280,280,280,280,280,280,280,280,280,280,280,280,280,280,280,280,280,280,280,280,280,406,360,280,280,280,280,280,361,280,280,280,280,280,280,225,226,226,226,226,227,280,280,280,280,280,280,280,280,280,280,280,280,280,280,280,280,280,280,280,280,280,280
316,316,316,316,316,316,317,280,280,280,280,280,280,280,280,280,406,280,280,280,280,280,280,280,280,280,280,280,280,280,280,280,280,280,280,280,280,280,280,280,280,280,280,280,361,280,280,280,280,407,360,280,270,271,271,271,271,272,280,280,280,280,280,280,280,280,280,280,280,280,280,280,280,280,280,280,280,280,280,280
280,280,280,280,280,280,280,280,280,280,280,280,280,280,280,280,280,280,280,280,280,280,280,280,280,280,280,280,280,280,280,280,280,280,280,280,280,280,280,280,280,280,405,360,280,280,280,280,280,405,280,280,270,271,271,271,271,272,280,280,280,280,280,280,280,280,280,280,280,280,280,280,280,280,280,280,280,280,280,280
280,280,280,280,280,280,280,280,280,280,280,280,280,280,280,280,280,280,362,280,280,280,280,280,280,280,280,280,280,280,280,280,280,280,280,280,280,280,280,280,280,280,280,280,280,280,280,280,361,280,280,280,270,271,271,271,240,317,280,280,280,280,280,280,280,280,280,280,280,280,280,280,280,280,280,280,280,280,280,280
360,280,280,280,280,280,280,280,280,407,360,280,280,280,280,280,280,280,280,280,280,280,280,280,280,280,280,280,280,280,280,280,280,280,280,280,280,280,280,280,280,280,280,280,280,280,280,360,280,280,280,280,270,271,271,271,272,280,280,280,280,280,280,280,280,280,280,280,280,280,280,280,280,280,280,280,280,280,280,280
280,280,280,280,280,361,360,362,280,280,280,280,280,280,280,280,280,280,280,280,280,280,280,280,280,280,280,280,280,280,280,280,280,280,280,280,280,280,280,280,280,280,280,280,280,280,361,280,280,280,280,225,286,271,271,240,317,280,280,280,280,280,280,280,280,280,280,280,280,280,280,280,280,280,280,280,280,280,280,280
280,280,280,280,280,280,280,280,280,280,280,280,280,280,280,280,280,280,280,280,280,406,280,280,280,280,280,280,280,280,280,280,280,280,280,280,280,280,280,280,280,280,280,280,362,362,362,280,280,280,225,286,271,271,271,272,280,280,280,280,280,280,280,280,280,280,280,280,280,280,280,280,280,280,280,280,280,280,280,280
280,280,280,280,280,280,280,280,280,280,280,280,280,280,280,280,280,280,280,280,280,280,280,280,280,280,280,280,280,280,280,280,280,280,280,280,280,280,280,280,280,280,280,280,280,361,362,280,280,225,286,271,271,271,240,317,280,360,280,280,280,280,280,280,280,280,280,280,280,280,280,280,280,280,280,280,280,280,280,280
280,280,280,280,280,280,280,280,280,280,280,280,280,280,280,280,280,280,280,280,362,280,280,280,280,280,280,280,280,280,280,280,280,280,280,280,280,280,280,280,280,280,280,280,280,280,280,280,225,286,271,271,271,240,317,280,280,362,280,280,280,280,280,280,280,280,280,280,280,280,280,280,280,280,280,280,280,280,280,280
280,280,280,280,280,280,280,280,280,280,280,280,280,280,280,280,280,280,280,280,280,280,280,280,280,280,280,280,280,280,280,280,280,280,280,280,280,280,280,280,280,280,280,280,280,280,280,225,286,271,271,271,271,272,280,280,280,280,280,280,280,280,280,280,280,280,280,280,280,280,280,280,280,280,280,280,280,280,280,280
226,226,226,227,280,280,280,280,280,280,280,280,280,280,280,280,280,280,280,280,280,280,280,280,280,280,280,280,280,280,280,280,280,280,280,280,280,280,280,280,280,280,280,280,280,280,225,286,271,271,271,271,240,317,280,280,280,280,280,280,280,280,280,280,280,280,280,280,280,280,280,280,280,280,280,280,280,280,280,280
271,271,271,285,226,226,226,226,226,226,226,226,226,227,280,280,280,280,280,280,280,361,280,280,280,280,280,280,280,280,280,280,280,280,280,280,280,280,280,280,280,280,280,280,280,225,286,271,271,271,271,240,317,280,280,280,280,280,280,280,280,280,280,280,280,280,280,280,280,280,280,280,280,280,280,280,280,280,280,280
271,271,271,271,271,271,271,271,271,271,271,271,271,272,280,280,280,280,280,280,280,360,280,280,280,280,280,280,280,280,362,280,280,280,280,280,280,280,280,280,280,280,280,225,226,286,271,271,271,271,240,317,280,280,280,362,280,280,280,280,280,280,280,280,280,280,280,280,280,280,280,280,280,280,280,280,280,280,280,280
271,271,271,271,271,271,271,271,271,240,316,316,316,317,280,280,280,280,280,280,280,280,280,280,280,280,280,280,280,280,407,280,280,280,280,280,280,280,280,280,280,280,225,286,271,271,271,271,271,240,317,280,280,280,405,360,405,280,280,280,280,280,280,280,280,280,280,280,280,280,280,280,280,280,280,280,280,280,280,280
271,271,271,271,271,271,271,271,271,272,280,280,280,280,280,280,280,280,280,280,280,280,280,280,280,280,280,280,280,280,280,280,280,280,280,280,280,280,280,280,225,226,286,271,271,271,271,271,240,317,280,360,280,280,280,280,280,280,280,280,280,280,280,280,280,280,280,280,280,280,280,280,280,280,280,280,280,280,280,280
271,271,271,271,271,271,271,271,240,317,280,280,280,280,280,280,280,280,280,280,280,280,280,280,280,280,280,280,280,280,280,280,407,280,280,280,280,280,225,226,286,271,271,271,271,271,271,271,272,280,280,280,280,280,280,280,280,280,280,280,280,280,280,280,280,280,280,280,280,280,280,280,280,280,280,280,280,280,280,280
271,240,316,316,316,316,316,316,317,280,280,280,280,405,280,280,280,280,280,280,280,280,280,280,280,280,280,280,280,280,280,280,280,280,280,280,225,226,286,271,271,271,271,271,271,271,271,240,317,280,280,280,280,280,280,280,280,280,280,280,280,280,280,280,280,280,280,280,280,280,280,280,280,280,280,280,280,280,280,280
316,317,280,280,280,280,280,280,280,280,280,280,280,280,280,280,280,280,280,280,280,280,280,280,280,280,280,280,280,280,280,280,280,280,280,225,286,271,271,271,271,271,271,271,271,240,316,317,361,280,280,280,280,280,280,280,280,280,280,280,280,280,280,280,280,280,280,280,280,280,280,280,280,280,280,280,280,280,280,280
280,280,280,280,280,280,280,280,280,280,280,280,280,280,280,280,280,280,280,280,280,280,280,280,280,280,280,280,280,280,280,280,280,225,226,286,271,271,271,271,271,271,240,316,316,317,280,280,362,280,280,280,280,280,280,280,280,280,280,280,280,280,280,280,280,280,280,280,280,280,280,280,280,280,280,280,280,280,280,280
280,280,280,280,280,280,280,280,280,280,280,280,280,280,280,280,280,280,280,280,280,280,280,280,280,280,280,280,280,280,280,225,226,286,271,271,271,271,271,240,316,316,317,280,280,280,280,280,280,280,280,280,280,280,280,280,280,280,280,280,280,280,280,280,280,280,280,280,280,280,280,280,280,280,280,280,280,280,280,280
280,280,280,280,280,280,280,280,280,280,280,280,280,280,280,407,362,280,280,280,280,280,280,280,280,280,280,280,280,225,226,286,271,271,271,271,271,240,316,317,280,280,280,280,280,406,361,280,280,280,280,280,280,280,280,280,280,280,280,280,280,280,280,280,280,280,280,280,280,280,280,280,280,280,280,280,280,280,280,280
280,280,280,280,280,280,280,280,280,280,280,280,280,280,280,280,280,280,280,280,280,280,280,225,226,227,225,226,226,286,271,271,271,271,271,240,316,317,280,280,280,280,280,280,280,407,280,280,280,280,280,280,280,280,280,280,280,280,280,280,280,280,280,280,280,280,280,280,280,280,280,280,280,280,280,280,280,280,280,-1
280,280,280,280,280,280,280,405,280,280,280,280,280,280,280,280,280,280,280,280,280,280,280,270,271,285,286,271,271,271,271,271,271,271,240,317,280,280,407,280,280,280,280,280,280,280,280,280,280,280,280,280,280,280,280,280,280,280,280,280,280,280,280,280,280,280,280,280,280,280,280,280,280,280,280,280,280,280,280,-1
280,280,280,280,280,280,361,361,280,280,280,280,280,280,280,280,280,280,280,280,280,280,280,270,271,271,271,271,271,271,271,271,271,271,272,280,280,360,407,280,280,280,280,280,280,280,280,280,280,280,280,280,280,280,280,280,280,280,280,280,280,280,280,280,280,280,280,280,280,280,280,280,280,280,280,280,280,280,280,-1
361,280,280,280,280,280,280,280,280,280,280,362,280,280,280,280,280,280,280,280,280,225,226,286,271,271,271,271,271,271,271,271,271,271,272,280,280,280,280,280,280,280,280,280,280,280,280,280,280,280,280,280,280,280,280,280,280,280,280,280,280,280,280,280,280,280,280,280,280,280,280,280,280,280,280,280,280,280,280,-1
280,406,280,280,280,280,280,280,280,280,280,280,280,280,280,280,280,280,280,280,280,270,271,271,271,271,271,271,271,271,271,271,240,316,317,280,280,280,280,280,280,280,280,280,280,280,280,280,280,280,280,280,280,280,280,280,280,280,280,280,280,280,280,280,280,280,280,280,280,280,280,280,280,280,280,280,280,280,280,-1
280,280,280,280,280,280,280,280,280,280,280,280,280,280,280,280,280,280,280,280,225,286,271,271,271,271,271,271,271,271,271,240,317,280,280,280,280,280,280,280,280,280,280,280,280,280,280,280,280,280,280,280,280,280,280,280,280,280,280,280,280,280,280,280,280,280,280,280,280,280,280,280,280,280,280,280,280,280,280,-1
280,280,280,280,280,280,280,280,280,280,280,280,280,280,280,280,280,280,280,225,286,271,271,271,271,271,271,271,271,271,271,272,280,280,280,280,280,280,280,280,280,280,280,280,280,280,280,280,280,280,280,280,280,280,280,280,280,280,280,280,280,280,280,280,280,280,280,280,280,280,280,280,280,280,280,280,280,280,280,-1
280,280,280,280,280,280,280,280,280,280,280,280,280,280,280,225,226,226,226,286,271,271,271,271,271,271,271,240,241,271,271,272,280,280,280,280,280,280,280,280,280,280,280,280,280,280,280,280,280,280,280,280,280,280,280,280,280,280,280,280,280,280,280,280,280,280,280,280,280,280,280,280,280,280,280,280,280,280,280,-1
280,280,280,280,280,280,280,280,280,280,280,280,280,280,225,286,271,271,271,271,271,271,271,271,271,271,271,285,286,271,240,317,280,280,280,280,280,280,280,280,280,280,280,280,280,280,280,280,280,280,280,280,280,280,280,280,280,280,280,280,280,280,280,280,280,280,280,280,280,280,280,280,280,280,280,280,280,280,280,-1
280,280,280,280,280,280,360,407,406,280,280,280,225,226,286,271,271,271,271,271,271,271,271,271,271,271,271,271,271,271,272,280,280,280,280,280,280,280,280,280,280,280,280,280,280,280,280,280,280,280,280,280,280,280,280,280,280,280,280,280,280,280,280,280,280,280,280,280,280,280,280,280,280,280,280,280,280,280,280,-1
