412,274,274,368,274,274,274,275,271,271,271,271,271,271,271,271,271,271,273,274,274,274,274,274,274,274,274,274,274,274,274,274,274,274,274,274,274,274,274,274,274,274,274,274,287,288,274,274,274,275,271,271,271,271,272,385,270,364,271,272,385,385,385,385,385,385,385,385,385,385,385,407,385,385,385,385,385,385,385,385
368,274,274,274,242,319,319,320,271,364,271,271,271,365,271,271,410,271,318,319,243,274,274,274,274,412,366,274,274,367,411,274,274,274,274,274,274,274,274,274,274,274,274,274,274,412,274,274,274,287,230,271,409,271,272,385,270,271,240,317,385,385,406,407,362,385,385,385,385,406,385,385,385,385,385,385,385,385,385,385
274,274,274,274,275,271,271,271,271,271,271,271,271,271,409,271,271,271,408,271,318,319,319,243,274,274,274,274,274,274,413,366,274,274,274,413,274,274,274,274,274,367,366,274,274,412,274,274,274,274,275,271,271,271,272,385,270,365,285,227,385,385,385,405,385,385,385,385,385,385,405,385,405,385,385,385,385,385,385,385
412,413,274,274,275,271,409,271,364,408,271,271,271,271,271,408,271,271,364,271,271,271,271,318,243,274,274,274,411,274,367,274,274,274,274,274,274,274,274,274,274,274,274,274,274,274,274,274,274,274,275,271,365,240,317,385,270,271,271,272,385,385,385,362,385,385,385,385,385,385,362,385,385,405,385,385,385,385,385,385
274,274,242,319,320,271,271,271,271,271,271,271,364,271,271,409,271,271,271,363,271,271,271,271,273,274,274,274,274,274,274,274,274,274,274,274,274,274,274,413,274,274,274,274,274,274,274,274,242,319,320,271,271,272,385,385,315,241,364,272,385,385,385,385,385,385,385,385,385,405,362,385,385,362,385,385,385,385,385,385
274,274,287,230,271,271,271,271,271,409,271,271,271,271,271,271,271,408,271,271,271,271,271,271,273,274,274,274,274,274,274,366,274,274,274,274,274,367,274,274,274,274,412,274,274,274,274,274,275,271,271,271,271,272,385,385,385,270,271,272,385,385,385,385,385,385,406,362,385,362,385,385,406,385,385,385,385,385,385,385
368,274,274,275,271,271,271,363,271,271,271,240,316,316,316,316,241,271,271,271,271,271,271,271,273,274,274,366,274,274,274,366,274,274,274,412,274,274,274,274,274,274,274,274,274,274,274,274,275,271,271,365,271,272,385,385,385,270,409,272,385,385,385,385,385,385,385,385,362,385,385,385,385,385,385,385,385,385,385,385
274,242,319,320,271,271,271,271,271,240,316,317,385,385,385,385,315,316,316,241,271,271,410,271,318,243,274,274,274,274,274,274,274,274,274,274,274,274,274,274,274,274,274,413,274,274,274,274,275,271,271,271,271,272,385,385,225,286,271,272,385,385,385,385,385,385,385,385,407,385,385,385,385,385,385,385,385,385,385,385
274,287,230,271,271,410,271,271,240,317,385,385,385,385,385,385,385,385,385,315,241,271,271,271,271,318,319,243,274,274,274,274,274,274,274,274,274,412,274,274,274,274,413,274,274,274,412,274,287,230,271,271,271,272,385,385,270,271,240,317,385,385,385,385,385,385,385,385,385,385,385,385,385,385,385,385,385,385,385,385
274,274,275,271,271,363,271,240,317,385,385,385,385,385,385,385,385,385,385,385,270,271,271,271,271,271,271,318,243,274,274,366,274,274,274,274,368,413,274,274,411,274,274,274,274,274,366,274,274,275,271,365,240,317,385,225,286,271,272,385,385,385,385,385,385,385,385,385,385,385,385,385,385,385,385,385,385,385,385,385
274,242,320,271,271,271,240,317,385,385,385,385,385,385,385,385,385,385,385,385,270,271,408,271,408,271,271,271,273,274,274,274,274,274,274,367,366,274,274,274,274,274,274,413,366,274,274,274,242,320,271,365,272,385,225,286,364,271,272,385,385,385,385,385,385,385,385,362,385,385,385,385,385,385,385,385,385,385,385,385
274,275,271,363,271,240,317,385,385,385,385,385,385,361,385,385,385,385,385,385,315,241,271,271,271,271,271,271,318,243,274,274,274,274,274,274,274,274,274,413,412,274,274,274,413,411,274,242,320,271,271,271,272,385,270,271,271,240,317,385,385,407,362,385,385,385,385,385,385,385,385,385,385,385,385,385,385,385,385,385
412,275,271,271,271,272,385,385,406,385,385,385,385,385,385,385,385,385,385,385,385,270,271,271,271,271,365,271,271,273,274,274,366,274,274,274,274,274,368,368,274,274,274,274,274,274,274,275,271,271,364,271,272,225,286,271,240,317,385,385,385,385,385,385,385,385,385,385,385,385,385,406,385,385,385,385,385,385,385,385
274,275,271,271,271,272,385,385,407,385,385,385,406,385,385,385,385,385,385,385,385,315,241,271,271,271,271,271,271,273,274,274,411,274,274,274,274,274,274,274,274,274,274,274,274,274,274,275,271,271,271,271,285,286,271,271,272,385,385,385,360,385,385,385,385,385,385,385,385,385,385,406,385,385,385,385,385,385,385,385
274,287,230,271,240,317,385,385,385,385,385,385,385,385,385,385,385,385,385,385,385,385,270,271,271,410,271,271,271,273,274,274,274,274,274,274,274,274,274,367,274,274,274,274,274,413,242,320,271,365,271,271,271,364,271,240,317,385,385,385,385,385,385,385,407,405,385,385,385,385,385,405,385,385,385,385,385,385,385,385
411,274,275,271,272,385,385,385,385,385,385,407,361,385,385,385,385,407,385,385,385,385,270,271,271,271,271,271,271,273,274,274,274,274,274,274,274,274,274,274,274,274,274,274,274,274,287,230,271,271,271,271,271,271,240,317,385,385,385,385,385,385,385,385,385,385,385,385,385,385,385,406,385,385,385,385,385,385,385,385
274,242,320,271,285,227,385,385,385,385,385,385,360,385,385,385,385,406,385,385,385,385,270,271,271,271,271,271,228,288,412,274,274,274,274,274,274,274,274,274,274,274,413,367,274,274,274,275,271,271,408,271,271,240,317,385,385,385,385,385,385,407,362,385,385,385,385,361,407,405,385,385,385,385,385,385,385,385,385,385
367,275,271,271,271,272,385,385,385,385,385,407,385,385,385,385,385,385,360,385,385,385,315,241,271,271,271,271,273,274,274,274,274,366,368,274,274,274,274,274,274,274,274,274,274,274,242,320,271,271,271,271,240,317,385,385,385,385,385,385,385,360,385,385,385,385,385,385,385,385,385,385,385,385,385,385,385,385,385,385
274,275,271,271,271,285,227,385,385,385,385,385,385,385,385,385,385,385,361,385,385,385,385,315,241,271,271,271,273,274,274,274,274,274,367,411,412,274,274,274,274,411,274,274,274,274,275,271,271,271,271,240,317,385,385,385,385,385,385,385,385,385,385,385,385,385,385,385,385,385,385,385,385,385,385,385,385,385,385,385
274,275,271,410,271,271,272,385,385,385,385,385,385,385,385,385,385,385,385,385,385,385,385,385,270,271,409,271,318,319,243,274,274,274,274,274,274,367,274,274,274,368,274,274,274,274,275,271,271,271,271,272,385,385,385,385,385,385,385,385,385,385,385,385,385,385,385,385,385,362,385,385,385,385,385,385,385,385,385,385
366,287,230,271,271,271,272,385,385,385,385,385,385,385,385,385,385,385,385,407,385,385,385,385,270,271,271,271,271,228,288,274,274,274,274,274,274,274,274,274,274,274,274,274,274,274,275,271,271,271,240,317,385,385,385,385,406,385,385,385,385,385,385,385,385,385,385,385,385,385,385,385,385,385,385,385,385,385,385,385
274,274,275,271,271,364,285,227,385,385,385,385,360,385,385,360,385,385,385,407,385,385,385,385,315,241,271,271,271,273,274,274,274,274,274,368,274,274,274,274,274,274,274,274,274,274,275,271,408,271,272,385,385,385,385,385,406,385,385,385,385,385,385,385,385,385,385,385,385,385,385,385,385,385,385,385,385,385,385,385
274,242,320,271,271,271,271,285,227,385,385,385,385,385,385,385,362,385,385,385,385,385,385,385,225,286,271,271,271,273,274,274,367,413,274,274,274,274,274,274,274,274,274,274,274,242,320,271,271,271,272,385,385,385,385,405,362,385,385,385,385,385,385,385,406,385,385,385,385,385,385,385,385,385,385,385,385,385,385,385
274,287,230,271,271,271,271,271,285,227,385,385,405,385,385,385,385,360,385,385,385,385,385,385,270,271,271,271,365,273,274,274,274,367,274,274,274,274,412,274,413,411,274,274,242,320,271,271,271,271,272,385,385,385,405,407,385,385,385,385,385,385,385,385,385,385,362,385,385,385,385,385,385,385,385,385,385,385,385,385
367,274,275,271,271,271,271,271,271,272,385,385,385,385,385,406,407,385,385,385,385,385,385,385,270,408,271,271,271,273,274,366,274,274,274,413,274,274,274,274,274,274,274,274,275,271,271,409,271,271,272,385,385,385,360,385,385,385,385,385,385,385,385,385,385,385,385,385,385,385,385,385,385,385,385,385,385,385,385,385
413,366,287,230,271,365,271,271,271,285,227,385,385,385,361,385,385,385,385,362,385,385,385,385,270,271,271,271,271,273,274,274,274,274,274,367,274,274,274,274,274,274,274,242,320,271,271,271,271,271,272,385,385,361,385,385,385,385,385,385,405,362,385,385,385,385,385,385,385,385,385,385,385,385,385,385,385,385,385,385
274,413,274,275,271,271,271,271,271,271,285,227,385,361,385,385,385,385,385,385,385,385,385,385,270,271,271,408,271,273,274,274,368,413,274,274,274,274,274,274,274,242,319,320,271,271,365,271,271,240,317,385,361,385,385,385,385,385,385,385,385,385,406,360,385,385,385,385,385,385,385,385,385,385,385,385,385,385,385,385
274,274,274,275,271,271,271,271,271,271,271,272,385,385,385,385,385,385,407,385,385,385,385,385,270,271,410,271,271,273,274,274,274,274,274,274,242,319,319,319,319,320,271,271,271,271,271,271,240,317,360,361,385,385,385,385,361,385,385,385,385,385,385,405,385,385,385,385,385,385,385,385,385,385,385,385,385,385,385,385
274,274,274,275,271,271,271,364,408,364,271,272,385,360,407,385,385,385,362,385,385,385,385,385,270,271,271,271,228,288,274,274,274,274,368,274,275,271,271,271,271,271,271,364,271,271,271,240,317,385,362,385,385,385,385,385,385,362,385,385,385,385,385,385,385,385,385,385,385,385,385,385,385,385,385,385,385,385,385,385
274,274,274,287,230,271,271,271,271,271,271,272,385,385,385,385,385,385,360,385,385,385,385,385,270,271,271,271,273,413,274,411,274,274,274,242,320,271,271,271,271,271,271,271,271,364,271,272,385,405,385,385,385,385,385,385,385,406,385,385,385,385,385,385,385,385,385,385,385,385,385,385,385,385,385,385,385,385,385,385
274,368,274,274,275,271,271,271,271,271,240,317,385,362,385,405,385,385,385,385,385,385,385,225,286,271,271,271,273,274,274,274,274,242,319,320,271,271,271,364,365,271,271,271,240,316,316,317,385,405,385,385,385,361,385,385,385,360,385,385,385,385,385,385,407,385,385,385,385,385,385,385,385,385,385,385,385,385,385,385
274,274,274,274,275,271,271,409,271,240,317,385,385,385,385,385,385,385,385,385,385,385,225,286,271,271,271,271,273,274,413,274,242,320,271,271,271,271,365,271,410,271,271,240,317,385,385,385,385,385,385,385,385,407,385,385,385,362,385,385,362,405,360,360,360,360,385,385,385,385,385,385,385,385,385,385,385,385,385,385
274,274,412,274,287,230,271,271,271,272,385,385,360,385,385,385,385,362,385,385,385,385,270,271,271,271,271,271,273,274,274,242,320,271,271,271,271,271,408,271,271,271,271,272,385,385,385,385,385,385,385,385,385,385,385,385,385,385,385,385,385,385,385,385,385,360,385,385,385,385,385,385,385,385,385,385,385,385,385,385
274,274,274,274,274,287,230,271,271,272,385,385,385,385,361,385,385,385,385,385,385,225,286,271,271,271,364,271,318,319,319,320,271,271,271,271,271,271,271,271,271,240,316,317,385,385,385,385,385,385,385,385,385,385,385,385,385,385,385,385,385,406,385,385,385,385,385,385,385,385,385,385,385,385,385,385,385,385,385,385
274,413,274,413,274,274,275,271,271,272,385,385,385,385,385,385,385,385,385,385,385,270,271,271,271,271,271,271,271,271,271,271,271,271,410,271,271,271,271,271,240,317,385,385,385,385,385,385,385,385,362,405,405,385,385,406,406,385,385,385,385,385,385,385,385,385,385,385,385,385,385,385,385,385,385,385,385,385,385,385
274,274,274,274,274,242,320,271,271,272,385,385,385,385,385,385,385,385,385,385,385,270,271,410,409,365,271,271,271,271,271,271,271,271,271,365,271,271,271,240,317,385,385,385,385,385,362,360,362,405,361,385,385,385,385,385,405,385,385,385,385,385,385,385,385,385,385,385,385,385,385,385,385,385,385,385,385,385,385,385
368,274,274,274,274,275,271,271,240,317,385,385,385,385,385,385,385,385,385,385,385,270,271,271,271,365,271,271,271,271,363,271,271,271,271,271,240,316,316,317,385,385,385,385,385,362,361,385,385,385,385,406,362,385,385,385,385,361,385,385,385,385,361,406,405,385,385,385,385,385,385,385,385,385,385,385,385,385,385,385
274,411,274,274,242,320,271,271,272,385,385,385,407,385,385,385,385,385,385,385,385,315,241,271,271,271,271,271,271,271,271,271,271,271,271,240,317,385,385,385,385,385,385,385,407,385,385,385,385,385,385,385,385,385,385,385,385,385,385,385,385,385,385,385,362,385,385,385,385,385,385,385,385,385,385,385,385,385,385,385
274,274,274,242,320,271,271,271,272,385,385,385,385,385,385,385,385,361,385,385,385,385,270,271,408,271,271,271,409,271,271,271,271,240,316,317,385,385,385,406,385,405,385,385,385,385,385,406,405,385,385,385,385,385,385,385,385,385,385,385,385,385,385,385,385,385,385,385,385,385,385,385,385,385,385,385,385,385,385,385
274,411,274,275,271,271,271,271,272,385,385,385,385,385,407,385,406,406,385,385,385,385,315,241,271,271,271,271,364,271,271,271,240,317,385,385,385,385,385,406,385,385,385,385,385,385,385,385,385,385,406,362,385,385,385,385,385,385,385,385,385,385,385,385,385,385,385,385,385,385,385,385,385,385,385,385,385,385,385,385
243,368,274,275,271,271,364,271,272,385,385,385,385,406,385,385,385,385,385,362,385,385,385,315,316,316,241,271,271,271,240,316,317,385,385,385,385,385,385,405,385,385,385,385,385,385,385,385,385,385,385,385,385,385,385,385,385,407,385,385,385,385,385,385,385,385,385,385,385,385,385,385,385,385,385,385,385,385,385,385
273,274,274,275,271,271,271,240,317,385,385,385,385,385,385,385,385,385,385,385,385,385,385,385,385,385,315,316,316,316,317,385,385,385,385,385,385,385,385,361,405,405,385,385,385,385,385,385,385,385,385,385,385,385,385,385,385,360,361,385,385,385,385,385,385,385,385,385,385,385,385,385,385,385,385,385,385,385,385,385
273,274,242,320,271,271,271,272,385,385,385,385,385,385,385,385,385,385,385,385,385,385,385,385,385,385,385,385,385,385,385,385,385,385,385,385,385,385,385,385,385,385,385,385,385,405,385,385,385,385,385,361,385,385,385,385,385,385,362,385,385,385,385,385,385,385,385,385,385,385,385,385,385,385,385,385,385,385,385,385
318,319,320,271,409,240,316,317,385,385,385,385,385,385,385,385,385,385,385,405,385,385,362,385,385,385,385,385,385,385,385,385,385,385,385,385,385,385,385,385,361,385,385,385,385,385,385,385,385,385,405,407,385,385,385,385,385,385,385,385,385,385,385,385,385,385,385,385,385,385,385,385,385,385,385,385,385,385,385,385
271,271,271,271,271,272,385,385,385,385,385,385,385,407,385,385,385,361,385,385,385,385,362,360,385,385,385,385,385,385,385,385,385,385,385,385,385,385,385,385,385,385,361,385,385,385,385,385,385,385,385,385,385,385,385,385,385,385,385,360,385,385,385,385,385,385,385,385,385,385,385,385,385,385,385,385,385,385,385,385
271,271,365,271,240,317,385,385,385,362,385,385,385,385,385,385,385,385,385,385,385,385,385,406,385,385,385,385,362,407,385,407,360,385,385,407,405,385,385,385,385,385,385,385,385,385,385,385,385,385,385,385,385,405,385,385,385,385,385,385,385,385,385,385,385,385,385,385,385,385,385,385,385,385,385,385,385,385,385,385
271,271,271,240,317,385,385,385,360,406,385,385,385,385,385,385,385,385,385,385,361,360,405,360,406,405,385,385,385,385,385,385,385,385,385,385,385,385,385,385,385,385,385,361,385,385,385,385,385,360,360,385,360,385,385,385,407,385,385,385,385,385,385,385,385,385,385,385,385,385,385,385,385,385,385,385,385,385,385,385
316,316,316,317,385,385,385,385,385,385,385,385,385,406,385,385,362,385,385,385,385,385,385,385,385,385,385,385,385,385,385,385,385,405,385,385,361,385,385,385,385,385,385,385,385,385,385,385,385,385,385,385,407,385,385,385,385,385,385,385,385,385,385,385,385,385,385,385,385,385,385,385,385,385,385,385,385,385,385,385
385,385,385,385,385,385,385,385,385,385,385,385,385,385,385,362,407,385,385,385,385,385,385,405,385,385,385,385,385,385,385,385,385,385,385,385,385,385,385,385,385,385,385,385,385,361,385,385,385,385,385,385,385,385,385,385,385,385,385,385,385,385,385,385,385,385,385,385,385,385,385,385,385,385,385,385,385,385,385,385
385,385,406,407,362,385,405,385,385,385,385,385,385,385,360,385,385,385,385,385,385,385,385,385,385,385,385,385,385,385,385,385,385,385,385,385,385,385,385,385,385,385,385,385,385,385,385,385,385,385,385,385,385,385,385,385,385,385,385,385,385,385,385,385,385,385,385,385,385,385,385,385,385,385,385,385,280,385,385,385
385,362,385,385,385,361,385,385,385,385,385,385,385,385,385,385,385,385,385,385,385,385,385,385,385,385,406,385,385,385,385,385,385,385,385,385,385,385,385,385,385,385,385,385,385,385,385,385,385,385,385,385,385,225,226,226,227,225,226,226,226,227,385,385,385,385,385,385,385,385,385,385,385,385,385,280,280,385,385,385
385,385,385,385,385,385,385,361,360,385,385,385,385,385,385,385,385,385,385,385,385,385,385,385,385,385,385,385,225,226,226,226,226,226,226,227,385,385,385,385,385,385,385,385,385,385,385,385,385,385,385,385,225,286,271,271,285,286,271,271,271,285,227,385,385,385,385,385,385,385,385,385,385,385,385,280,385,385,385,385
385,385,385,385,385,385,385,406,385,385,385,385,385,385,385,360,385,385,385,385,385,385,385,385,385,385,225,226,286,271,271,365,271,271,271,285,227,385,385,385,385,385,385,385,385,225,226,226,226,226,226,226,286,271,271,271,271,271,271,271,271,271,272,385,385,385,385,385,385,385,385,385,280,385,280,280,385,385,385,385
385,385,385,385,385,385,385,407,385,385,385,385,385,385,385,385,385,385,406,385,385,385,385,385,385,225,286,271,271,271,410,271,271,410,271,271,272,225,226,226,226,226,227,225,226,286,271,271,271,271,409,271,271,271,271,271,365,365,271,271,271,271,272,385,385,385,385,385,385,385,385,385,385,385,280,385,385,385,385,385
385,385,385,385,385,385,385,385,385,385,385,385,385,385,385,385,385,385,362,385,385,385,385,385,225,286,271,271,271,271,271,271,271,271,240,316,317,270,271,271,271,271,285,286,271,271,409,271,271,271,271,271,271,410,410,271,271,271,271,271,271,271,272,385,385,385,385,385,385,385,385,385,280,385,280,385,385,385,385,385
385,385,385,385,405,385,385,385,385,385,385,385,385,360,385,385,385,385,385,385,385,385,225,226,286,271,271,363,271,271,228,229,230,271,271,385,385,270,271,271,271,271,271,409,271,271,271,271,228,229,229,229,230,271,271,271,271,271,271,271,240,316,317,385,385,385,385,385,385,385,385,385,385,280,385,385,385,385,385,385
385,385,385,385,385,360,385,385,385,385,385,385,385,360,385,385,385,385,385,385,385,225,286,271,271,271,271,271,271,228,288,274,275,271,385,385,385,270,271,271,271,271,271,271,271,228,229,229,288,274,274,274,287,229,230,271,271,271,410,271,272,385,385,385,385,385,385,385,385,280,280,385,280,280,385,385,385,385,385,385
385,385,385,385,385,385,385,385,385,385,385,385,385,385,385,385,385,385,385,225,226,286,271,271,408,271,271,271,228,288,274,274,275,385,385,385,385,315,316,316,241,271,271,271,271,273,274,274,274,274,274,274,274,274,287,230,271,271,271,271,272,385,385,385,385,280,385,385,280,280,280,280,280,385,385,385,385,385,385,385
385,361,385,385,385,385,385,385,385,385,385,385,385,385,385,385,385,225,226,286,271,409,271,271,271,271,363,228,288,274,274,242,320,385,385,385,385,385,385,385,315,241,271,271,271,318,319,319,243,368,274,412,274,274,274,275,271,271,271,271,272,385,385,280,385,385,385,280,280,280,280,385,280,385,385,385,385,385,385,385
385,385,385,385,385,385,385,385,385,385,385,385,385,225,226,226,226,286,271,271,271,271,228,229,229,229,229,288,274,274,242,320,385,385,385,385,385,385,385,385,385,315,316,241,271,271,271,271,273,274,274,368,274,366,274,275,271,271,271,271,272,385,385,385,385,385,385,280,385,280,385,280,385,385,385,385,385,385,385,385
385,385,385,385,385,385,385,385,385,385,385,385,225,286,271,271,271,271,271,364,271,271,273,274,274,274,274,274,274,242,320,385,385,385,385,385,385,385,385,385,385,385,385,315,316,316,241,271,273,274,274,367,274,413,274,275,271,408,271,240,317,385,385,385,385,385,280,280,280,280,385,280,385,385,385,385,385,385,385,385
385,362,385,385,385,385,385,385,385,385,385,225,286,271,364,271,408,271,271,271,271,228,288,274,242,319,319,319,319,320,385,385,385,385,385,385,385,385,385,385,385,385,385,385,385,385,315,271,273,274,274,274,274,274,274,275,271,271,271,272,385,385,385,385,385,280,280,385,280,385,280,385,385,385,385,385,385,385,385,385
385,385,385,385,385,385,385,385,385,385,225,286,271,271,271,271,271,271,228,229,229,288,274,274,275,271,271,271,271,385,385,385,385,385,385,385,385,385,385,385,385,385,385,385,385,385,385,271,318,319,319,243,274,274,242,320,271,271,271,272,385,385,385,385,385,280,280,385,280,385,280,385,385,385,385,385,385,385,385,385
385,385,385,362,385,385,385,385,385,225,286,271,364,408,271,271,228,229,288,274,274,274,274,242,320,271,385,385,385,385,385,385,385,385,385,385,385,385,385,385,385,385,385,385,385,385,385,271,271,271,271,318,243,274,275,271,271,271,240,317,385,385,385,385,385,385,385,385,280,280,385,385,385,385,385,385,385,385,385,385
385,385,385,385,385,385,385,385,225,286,271,271,363,271,271,228,288,274,274,274,242,319,319,320,385,385,385,385,385,385,385,385,385,385,385,385,385,385,385,385,385,385,385,385,385,385,385,385,385,385,271,271,318,319,320,410,240,316,317,385,385,385,385,385,385,385,385,385,280,385,385,385,385,385,385,385,385,385,385,385
385,385,385,385,385,385,385,385,270,363,271,271,271,271,228,288,274,274,242,319,320,385,385,385,385,385,385,385,385,385,385,385,385,385,385,385,385,385,385,385,385,385,385,385,385,385,385,385,385,385,270,271,271,271,271,271,317,385,385,385,385,385,385,385,385,385,385,385,385,385,385,385,385,385,385,385,385,385,385,385
385,385,385,225,226,226,226,226,286,271,271,271,271,228,288,274,274,242,320,385,385,385,385,385,385,385,385,385,385,385,385,385,385,385,385,385,385,385,385,385,385,385,385,385,385,385,385,385,385,385,315,316,316,316,316,317,385,385,385,385,385,385,385,385,385,385,385,385,385,385,385,385,385,385,385,385,385,385,385,385
225,226,226,286,271,271,271,271,271,271,228,229,229,288,274,274,242,320,385,385,385,385,385,385,385,385,385,385,385,385,385,385,385,385,385,385,385,385,385,385,385,385,385,385,385,385,385,385,385,385,385,385,385,385,385,385,385,385,385,385,385,385,385,385,385,385,385,385,385,385,385,385,385,385,385,385,385,385,385,385
286,271,271,365,271,271,271,271,228,229,288,274,274,274,242,319,320,385,385,385,385,385,385,385,385,385,385,385,385,385,385,385,385,385,385,385,385,385,385,385,385,385,385,385,385,385,385,385,385,385,385,385,385,385,385,385,385,385,385,385,385,385,385,385,385,385,385,385,385,385,385,385,385,385,385,385,385,385,385,385
271,271,408,271,271,271,271,228,288,274,274,274,242,319,320,385,385,385,385,385,385,385,385,385,385,385,385,385,385,385,385,385,385,385,385,385,385,385,385,385,385,385,385,385,385,385,385,385,385,385,385,385,385,385,385,385,385,385,385,385,385,385,385,385,385,385,385,385,385,385,385,385,385,385,385,385,385,385,385,385
410,271,271,271,271,228,229,288,274,274,242,319,320,385,385,225,226,227,385,385,385,385,385,385,385,385,385,385,385,385,385,385,385,385,385,385,385,385,385,385,385,385,385,385,385,385,385,385,385,385,385,385,385,385,385,385,385,385,385,385,385,385,385,385,385,385,385,385,385,385,385,385,385,385,385,385,385,385,385,385
271,271,228,229,229,288,368,274,274,242,320,225,226,226,226,286,271,272,385,385,385,385,385,385,385,385,385,385,385,385,385,385,385,385,385,385,385,385,385,385,385,385,385,385,385,385,385,385,385,385,385,385,385,385,385,385,385,385,385,385,385,385,385,385,385,385,385,385,385,385,385,385,385,385,385,385,385,385,385,385
271,271,273,274,274,274,274,242,319,320,225,286,271,271,271,271,271,272,385,385,385,385,385,385,385,385,385,385,385,385,385,385,385,385,385,385,385,385,385,385,385,385,385,385,385,385,385,385,385,385,385,385,385,385,385,385,385,385,385,385,385,385,385,385,385,385,385,385,385,385,385,385,385,385,385,385,385,385,385,385
228,229,288,274,367,319,319,320,271,271,315,316,316,316,316,316,316,317,385,385,385,385,385,385,385,385,385,385,385,385,385,385,385,385,385,385,385,385,385,385,385,385,385,385,385,385,385,385,385,385,385,385,385,385,385,385,385,385,385,385,385,385,385,385,385,385,385,385,385,385,385,385,385,385,385,385,385,385,385,385
273,274,413,274,275,225,227,271,271,385,385,385,385,385,385,385,385,385,385,385,385,385,385,385,385,385,385,385,385,385,385,385,385,385,385,385,385,385,385,385,385,385,385,385,385,385,385,385,385,385,385,385,385,385,385,385,385,385,385,385,385,385,385,385,385,385,385,385,385,385,385,385,385,385,385,385,385,385,385,385
318,319,243,274,275,315,317,385,385,385,385,385,385,385,385,385,385,385,385,385,385,385,385,385,385,385,385,385,385,385,385,385,385,385,385,385,385,385,385,385,385,385,385,385,385,385,385,385,385,385,385,385,385,385,385,385,385,385,385,385,385,385,385,385,385,385,385,385,385,385,385,385,385,385,385,385,385,385,385,385
226,227,318,319,320,385,385,385,385,385,385,385,385,385,385,385,385,385,385,385,385,385,385,385,385,385,385,385,385,385,385,385,385,385,385,385,385,385,385,385,385,385,385,385,385,385,385,385,385,385,385,385,385,385,385,385,385,385,385,385,385,385,385,385,385,385,385,385,385,385,385,385,385,385,385,385,385,385,385,385
271,272,271,385,385,385,385,385,385,385,385,385,385,385,385,385,385,385,385,385,385,385,385,385,385,385,385,385,385,385,385,385,385,385,385,385,385,385,385,385,385,385,385,385,385,385,385,385,385,385,385,385,385,385,385,385,385,385,385,385,385,385,385,385,385,385,385,385,385,385,385,385,385,385,385,385,385,385,385,385
316,317,385,385,385,385,385,385,385,385,385,385,385,385,385,385,385,385,385,385,385,385,385,385,385,385,385,385,385,385,385,385,385,385,385,385,385,385,385,385,385,385,385,385,385,385,385,385,385,385,385,385,385,385,385,385,385,385,385,385,385,385,385,385,385,385,385,385,385,385,385,385,385,385,385,385,385,385,385,385
385,385,385,385,385,385,385,385,385,385,385,385,385,385,385,385,385,385,385,385,385,385,385,385,385,385,385,385,385,385,385,385,385,385,385,385,385,385,385,385,385,385,385,385,385,385,385,385,385,385,385,385,385,385,385,385,385,385,385,385,385,385,385,385,385,385,385,385,385,385,385,385,385,385,385,385,385,385,385,385
